.|.|.|.|.|.|.|.|.|.|.|.|.|.|.|.|,.|.|.|.|.|.|.|.|.|.|.|.|.|.|.|.|,.|.|.|.|.|.|.|.|.|.|.|.|.|.|.|.|,.|.|.|.|.|.|.|.|.|.|.|.|.|.|.|.|,.|.|.|.|.|.|.|.|.|.|.|.|.|.|.|.|,.|.|.|.|.|.|.|.|.|.|.|.|.|.|.|.|,.|.|.|.|.|.|.|.|.|.|.|.|.|.|.|.|,.|.|.|.|.|.|.|.|.|.|.|.|.|.|.|.|,.|.|.|.|.|.|.|.|.|.|.|.|.|.|.|.|,.|.|.|.|.|.|.|.|.|.|.|.|.|.|.|.|,.|.|.|.|.|.|.|.|.|.|.|.|.|.|.|.|,.|.|.|.|.|.|.|.|.|.|.|.|.|.|.|.|,.|.|.|.|.|.|.|.|.|.|.|.|.|.|.|.|,.|.|.|.|.|.|.|.|.|.|.|.|.|.|.|.|,.|.|.|.|.|.|.|.|.|.|.|.|.|.|.|.|,.|.|.|.|.|.|.|.|.|.|.|.|.|.|.|.|,.|.|.|.|.|.|.|.|.|.|.|.|.|.|.|.|,.|.|.|.|.|.|.|.|.|.|.|.|.|.|.|.|,.|.|.|.|.|.|.|.|.|.|.|.|.|.|.|.|,.|.|.|.|.|.|.|.|.|.|.|.|.|.|.|.|,.|.|.|.|.|.|.|.|.|.|.|.|.|.|.|.|,.|.|.|.|.|.|.|.|.|.|.|.|.|.|.|.|,.|.|.|.|.|.|.|.|.|.|.|.|.|.|.|.|,.|.|.|.|.|.|.|.|.|.|.|.|.|.|.|.|,.|.|.|.|.|.|.|.|.|.|.|.|.|.|.|.|,.|.|.|.|.|.|.|.|.|.|.|.|.|.|.|.|,.|.|.|.|.|.|.|.|.|.|.|.|.|.|.|.|,.|.|.|.|.|.|.|.|.|.|.|.|.|.|.|.|
.|.|.|.|.|.|.|.|.|.|.|.|.|.|.|.|,.|.|.|.|.|.|.|.|.|.|.|.|.|.|.|.|,.|.|.|.|.|.|.|.|.|.|.|.|.|.|.|.|,.|.|.|.|.|.|.|.|.|.|.|.|.|.|.|.|,.|.|.|.|.|.|.|.|.|.|.|.|.|.|.|.|,.|.|.|.|.|.|.|.|.|.|.|.|.|.|.|.|,.|.|.|.|.|.|.|.|.|.|.|.|.|.|.|.|,.|.|.|.|.|.|.|.|.|.|.|.|.|.|.|.|,.|.|.|.|.|.|.|.|.|.|.|.|.|.|.|.|,.|.|.|.|.|.|.|.|.|.|.|.|.|.|.|.|,.|.|.|.|.|.|.|.|.|.|.|.|.|.|.|.|,.|.|.|.|.|.|.|.|.|.|.|.|.|.|.|.|,.|.|.|.|.|.|.|.|.|.|.|.|.|.|.|.|,.|.|.|.|.|.|.|.|.|.|.|.|.|.|.|.|,.|.|.|.|.|.|.|.|.|.|.|.|.|.|.|.|,.|.|.|.|.|.|.|.|.|.|.|.|.|.|.|.|,.|.|.|.|.|.|.|.|.|.|.|.|.|.|.|.|,.|.|.|.|.|.|.|.|.|.|.|.|.|.|.|.|,.|.|.|.|.|.|.|.|.|.|.|.|.|.|.|.|,.|.|.|.|.|.|.|.|.|.|.|.|.|.|.|.|,.|.|.|.|.|.|.|.|.|.|.|.|.|.|.|.|,.|.|.|.|.|.|.|.|.|.|.|.|.|.|.|.|,.|.|.|.|.|.|.|.|.|.|.|.|.|.|.|.|,.|.|.|.|.|.|.|.|.|.|.|.|.|.|.|.|,.|.|.|.|.|.|.|.|.|.|.|.|.|.|.|.|,.|.|.|.|.|.|.|.|.|.|.|.|.|.|.|.|,.|.|.|.|.|.|.|.|.|.|.|.|.|.|.|.|,.|.|.|.|.|.|.|.|.|.|.|.|.|.|.|.|
.|.|.|.|.|.|.|.|.|.|.|.|.|.|.|.|,.|.|.|.|.|.|.|.|.|.|.|.|.|.|.|.|,.|.|.|.|.|.|.|.|.|.|.|.|.|.|.|.|,.|.|.|.|.|.|.|.|.|.|.|.|.|.|.|.|,.|.|.|.|.|.|.|.|.|.|.|.|.|.|.|.|,.|.|.|.|.|.|.|.|.|.|.|.|.|.|.|.|,.|.|.|.|.|.|.|.|.|.|.|.|.|.|.|.|,.|.|.|.|.|.|.|.|.|.|.|.|.|.|.|.|,.|.|.|.|.|.|.|.|.|.|.|.|.|.|.|.|,.|.|.|.|.|.|.|.|.|.|.|.|.|.|.|.|,.|.|.|.|.|.|.|.|.|.|.|.|.|.|.|.|,.|.|.|.|.|.|.|.|.|.|.|.|.|.|.|.|,.|.|.|.|.|.|.|.|.|.|.|.|.|.|.|.|,.|.|.|.|.|.|.|.|.|.|.|.|.|.|.|.|,.|.|.|.|.|.|.|.|.|.|.|.|.|.|.|.|,.|.|.|.|.|.|.|.|.|.|.|.|.|.|.|.|,.|.|.|.|.|.|.|.|.|.|.|.|.|.|.|.|,.|.|.|.|.|.|.|.|.|.|.|.|.|.|.|.|,.|.|.|.|.|.|.|.|.|.|.|.|.|.|.|.|,.|.|.|.|.|.|.|.|.|.|.|.|.|.|.|.|,.|.|.|.|.|.|.|.|.|.|.|.|.|.|.|.|,.|.|.|.|.|.|.|.|.|.|.|.|.|.|.|.|,.|.|.|.|.|.|.|.|.|.|.|.|.|.|.|.|,.|.|.|.|.|.|.|.|.|.|.|.|.|.|.|.|,.|.|.|.|.|.|.|.|.|.|.|.|.|.|.|.|,.|.|.|.|.|.|.|.|.|.|.|.|.|.|.|.|,.|.|.|.|.|.|.|.|.|.|.|.|.|.|.|.|,.|.|.|.|.|.|.|.|.|.|.|.|.|.|.|.|
.|.|.|.|.|.|.|.|.|.|.|.|.|.|.|.|,.|.|.|.|.|.|.|.|.|.|.|.|.|.|.|.|,.|.|.|.|.|.|.|.|.|.|.|.|.|.|.|.|,.|.|.|.|.|.|.|.|.|.|.|.|.|.|.|.|,.|.|.|.|.|.|.|.|.|.|.|.|.|.|.|.|,.|.|.|.|.|.|.|.|.|.|.|.|.|.|.|.|,.|.|.|.|.|.|.|.|.|.|.|.|.|.|.|.|,.|.|.|.|.|.|.|.|.|.|.|.|.|.|.|.|,.|.|.|.|.|.|.|.|.|.|.|.|.|.|.|.|,.|.|.|.|.|.|.|.|.|.|.|.|.|.|.|.|,.|.|.|.|.|.|.|.|.|.|.|.|.|.|.|.|,.|.|.|.|.|.|.|.|.|.|.|.|.|.|.|.|,.|.|.|.|.|.|.|.|.|.|.|.|.|.|.|.|,.|.|.|.|.|.|.|.|.|.|.|.|.|.|.|.|,.|.|.|.|.|.|.|.|.|.|.|.|.|.|.|.|,.|.|.|.|.|.|.|.|.|.|.|.|.|.|.|.|,.|.|.|.|.|.|.|.|.|.|.|.|.|.|.|.|,.|.|.|.|.|.|.|.|.|.|.|.|.|.|.|.|,.|.|.|.|.|.|.|.|.|.|.|.|.|.|.|.|,.|.|.|.|.|.|.|.|.|.|.|.|.|.|.|.|,.|.|.|.|.|.|.|.|.|.|.|.|.|.|.|.|,.|.|.|.|.|.|.|.|.|.|.|.|.|.|.|.|,.|.|.|.|.|.|.|.|.|.|.|.|.|.|.|.|,.|.|.|.|.|.|.|.|.|.|.|.|.|.|.|.|,.|.|.|.|.|.|.|.|.|.|.|.|.|.|.|.|,.|.|.|.|.|.|.|.|.|.|.|.|.|.|.|.|,.|.|.|.|.|.|.|.|.|.|.|.|.|.|.|.|,.|.|.|.|.|.|.|.|.|.|.|.|.|.|.|.|
.|.|.|.|.|.|.|.|.|.|.|.|.|.|.|.|,.|.|.|.|.|.|.|.|.|.|.|.|.|.|.|.|,.|.|.|.|.|.|.|.|.|.|.|.|.|.|.|.|,.|.|.|.|.|.|.|.|.|.|.|.|.|.|.|.|,.|.|.|.|.|.|.|.|.|.|.|.|.|.|.|.|,.|.|.|.|.|.|.|.|.|.|.|.|.|.|.|.|,.|.|.|.|.|.|.|.|.|.|.|.|.|.|.|.|,.|.|.|.|.|.|.|.|.|.|.|.|.|.|.|.|,.|.|.|.|.|.|.|.|.|.|.|.|.|.|.|.|,.|.|.|.|.|.|.|.|.|.|.|.|.|.|.|.|,.|.|.|.|.|.|.|.|.|.|.|.|.|.|.|.|,F|W|.|W|.|0|K|.|.|.|.|.|.|.|.|.|,F|W|.|.|.|0|.|0|C|.|.|.|.|.|.|.|,F|W|.|.|.|0|K|.|.|.|.|.|.|.|.|.|,F|W|.|.|.|.|.|1|C|.|.|.|.|.|.|.|,F|W|.|.|.|0|K|.|.|.|.|.|.|.|.|.|,F|W|.|.|.|.|.|1|C|.|.|.|.|.|.|.|,.|.|.|W|.|.|.|.|.|.|.|.|.|.|.|.|,.|.|.|.|.|.|.|.|.|.|.|.|.|.|.|.|,.|.|.|.|.|.|.|.|.|.|.|.|.|.|.|.|,.|.|.|.|.|.|.|.|.|.|.|.|.|.|.|.|,.|.|.|.|.|.|.|.|.|.|.|.|.|.|.|.|,.|.|.|.|.|.|.|.|.|.|.|.|.|.|.|.|,.|.|.|.|.|.|.|.|.|.|.|.|.|.|.|.|,.|.|.|.|.|.|.|.|.|.|.|.|.|.|.|.|,.|.|.|.|.|.|.|.|.|.|.|.|.|.|.|.|,.|.|.|.|.|.|.|.|.|.|.|.|.|.|.|.|,.|.|.|.|.|.|.|.|.|.|.|.|.|.|.|.|
.|.|.|.|.|.|.|.|.|.|.|.|.|.|.|.|,.|.|.|.|.|.|.|.|.|.|.|.|.|.|.|.|,.|.|.|.|.|.|.|.|.|.|.|.|.|.|.|.|,.|.|.|.|.|.|.|.|.|.|.|.|.|.|.|.|,.|.|.|.|.|.|.|.|.|.|.|.|.|.|.|.|,.|.|.|.|.|.|.|.|.|.|.|.|.|.|.|.|,.|.|.|.|.|.|.|.|.|.|.|.|.|.|.|.|,.|.|.|.|.|.|.|.|.|.|.|.|.|.|.|.|,.|.|.|.|.|.|.|.|.|.|.|.|.|.|.|.|,.|.|.|.|.|.|.|.|.|.|.|.|.|.|.|.|,.|.|.|.|.|.|.|.|.|.|.|.|.|.|.|.|,F|.|.|W|.|.|.|.|.|.|.|.|.|.|.|.|,F|.|.|.|.|.|.|.|.|.|.|.|.|.|.|.|,F|.|.|.|.|.|.|.|.|.|.|.|.|.|.|.|,F|.|.|.|.|.|.|.|.|.|.|.|.|.|.|.|,F|.|.|.|.|.|.|.|.|.|.|.|.|.|.|.|,F|.|.|.|.|.|.|.|.|.|.|.|.|.|.|.|,.|.|.|W|.|.|.|.|.|.|.|.|.|.|.|.|,.|.|.|.|.|.|.|.|.|.|.|.|.|.|.|.|,.|.|.|.|.|.|.|.|.|.|.|.|.|.|.|.|,.|.|.|.|.|.|.|.|.|.|.|.|.|.|.|.|,.|.|.|.|.|.|.|.|.|.|.|.|.|.|.|.|,.|.|.|.|.|.|.|.|.|.|.|.|.|.|.|.|,.|.|.|.|.|.|.|.|.|.|.|.|.|.|.|.|,.|.|.|.|.|.|.|.|.|.|.|.|.|.|.|.|,.|.|.|.|.|.|.|.|.|.|.|.|.|.|.|.|,.|.|.|.|.|.|.|.|.|.|.|.|.|.|.|.|,.|.|.|.|.|.|.|.|.|.|.|.|.|.|.|.|
.|.|.|.|.|.|.|.|.|.|.|.|.|.|.|.|,.|.|.|.|.|.|.|.|.|.|.|.|.|.|.|.|,.|.|.|.|.|.|.|.|.|.|.|.|.|.|.|.|,.|.|.|.|.|.|.|.|.|.|.|.|.|.|.|.|,.|.|.|.|.|.|.|.|.|.|.|.|.|.|.|.|,.|.|.|.|.|.|.|.|.|.|.|.|.|.|.|.|,.|.|.|.|.|.|.|.|.|.|.|.|.|.|.|.|,.|.|.|.|.|.|.|.|.|.|.|.|.|.|.|.|,.|.|.|.|.|.|.|.|.|.|.|.|.|.|.|.|,.|.|.|.|.|.|.|.|.|.|.|.|.|.|.|.|,.|.|.|.|.|.|.|.|.|.|.|.|.|.|.|.|,F|.|.|W|.|.|.|.|.|.|.|.|.|.|.|.|,F|.|.|.|.|.|.|.|.|.|.|.|.|.|.|.|,F|.|.|.|.|.|.|.|.|.|.|.|.|.|.|.|,F|.|.|.|.|.|.|.|.|.|.|.|.|.|.|.|,F|.|.|.|.|.|.|.|.|.|.|.|.|.|.|.|,F|.|.|.|.|.|.|.|.|.|.|.|4|.|.|.|,F|W|.|W|D|.|.|1|F|.|.|.|.|.|.|.|,.|.|.|W|.|.|.|.|.|.|.|.|.|.|.|.|,.|.|.|.|.|.|.|.|.|.|.|.|.|.|.|.|,.|.|.|.|.|.|.|.|.|.|.|.|.|.|.|.|,.|.|.|.|.|.|.|.|.|.|.|.|.|.|.|.|,.|.|.|.|.|.|.|.|.|.|.|.|.|.|.|.|,.|.|.|.|.|.|.|.|.|.|.|.|.|.|.|.|,.|.|.|.|.|.|.|.|.|.|.|.|.|.|.|.|,.|.|.|.|.|.|.|.|.|.|.|.|.|.|.|.|,.|.|.|.|.|.|.|.|.|.|.|.|.|.|.|.|,.|.|.|.|.|.|.|.|.|.|.|.|.|.|.|.|
.|.|.|.|.|.|.|.|.|.|.|.|.|.|.|.|,.|.|.|.|.|.|.|.|.|.|.|.|.|.|.|.|,.|.|.|.|.|.|.|.|.|.|.|.|.|.|.|.|,.|.|.|.|.|.|.|.|.|.|.|.|.|.|.|.|,.|.|.|.|.|.|.|.|.|.|.|.|.|.|.|.|,.|.|.|.|.|.|.|.|.|.|.|.|.|.|.|.|,.|.|.|.|.|.|.|.|.|.|.|.|.|.|.|.|,.|.|.|.|.|.|.|.|.|.|.|.|.|.|.|.|,.|.|.|.|.|.|.|.|.|.|.|.|.|.|.|.|,.|.|.|.|.|.|.|.|.|.|.|.|.|.|.|.|,.|.|.|.|.|.|.|.|.|.|.|.|.|.|.|.|,F|.|.|W|.|.|.|.|.|.|.|.|.|.|.|.|,F|.|.|.|.|.|.|1|C|.|.|.|.|.|.|.|,F|.|.|.|.|2|K|.|.|.|.|.|.|.|.|.|,F|.|.|.|.|.|.|1|C|.|.|.|.|.|.|.|,F|.|.|.|.|2|K|.|.|.|.|.|.|.|.|.|,F|.|.|.|.|.|.|1|C|.|.|.|.|.|.|.|,F|.|.|W|.|.|.|2|F|.|.|.|.|.|H|.|,.|.|.|W|.|.|.|.|.|.|.|.|.|.|.|.|,.|.|.|.|.|.|.|.|.|.|.|.|.|.|.|.|,.|.|.|.|.|.|.|.|.|.|.|.|.|.|.|.|,.|.|.|.|.|.|.|.|.|.|.|.|.|.|.|.|,.|.|.|.|.|.|.|.|.|.|.|.|.|.|.|.|,.|.|.|.|.|.|.|.|.|.|.|.|.|.|.|.|,.|.|.|.|.|.|.|.|.|.|.|.|.|.|.|.|,.|.|.|.|.|.|.|.|.|.|.|.|.|.|.|.|,.|.|.|.|.|.|.|.|.|.|.|.|.|.|.|.|,.|.|.|.|.|.|.|.|.|.|.|.|.|.|.|.|
.|.|.|.|.|.|.|.|.|.|.|.|.|.|.|.|,.|.|.|.|.|.|.|.|.|.|.|.|.|.|.|.|,.|.|.|.|.|.|.|.|.|.|.|.|.|.|.|.|,.|.|.|.|.|.|.|.|.|.|.|.|.|.|.|.|,.|.|.|.|.|.|.|.|.|.|.|.|.|.|.|.|,.|.|.|.|.|.|.|.|.|.|.|.|.|.|.|.|,.|.|.|.|.|.|.|.|.|.|.|.|.|.|.|.|,.|.|.|.|.|.|.|.|.|.|.|.|.|.|.|.|,.|.|.|.|.|.|.|.|.|.|.|.|.|.|.|.|,.|.|.|.|.|.|.|.|.|.|.|.|.|.|.|.|,.|.|.|.|.|.|.|.|.|.|.|.|.|.|.|.|,F|.|.|W|.|.|.|.|.|.|.|.|.|.|.|.|,.|W|.|W|.|.|.|.|.|.|.|.|.|.|.|.|,.|W|.|.|.|.|.|.|.|.|.|.|.|.|.|.|,.|W|.|.|.|.|.|.|.|.|.|.|.|.|.|.|,.|W|.|.|.|.|.|.|.|.|.|.|.|.|.|.|,.|W|.|.|.|.|.|.|.|.|.|.|.|.|.|.|,.|W|.|.|.|.|.|.|.|.|.|.|.|.|.|.|,.|.|.|.|.|.|.|.|.|.|.|.|.|.|.|.|,.|.|.|.|.|.|.|.|.|.|.|.|.|.|.|.|,.|.|.|.|.|.|.|.|.|.|.|.|.|.|.|.|,.|.|.|.|.|.|.|.|.|.|.|.|.|.|.|.|,.|.|.|.|.|.|.|.|.|.|.|.|.|.|.|.|,.|.|.|.|.|.|.|.|.|.|.|.|.|.|.|.|,.|.|.|.|.|.|.|.|.|.|.|.|.|.|.|.|,.|.|.|.|.|.|.|.|.|.|.|.|.|.|.|.|,.|.|.|.|.|.|.|.|.|.|.|.|.|.|.|.|,.|.|.|.|.|.|.|.|.|.|.|.|.|.|.|.|
.|.|.|.|.|.|.|.|.|.|.|.|.|.|.|.|,.|.|.|.|.|.|.|.|.|.|.|.|.|.|.|.|,.|.|.|.|.|.|.|.|.|.|.|.|.|.|.|.|,.|.|.|.|.|.|.|.|.|.|.|.|.|.|.|.|,.|.|.|.|.|.|.|.|.|.|.|.|.|.|.|.|,.|.|.|.|.|.|.|.|.|.|.|.|.|.|.|.|,.|.|.|.|.|.|.|.|.|.|.|.|.|.|.|.|,.|.|.|.|.|.|.|.|.|.|.|.|.|.|.|.|,.|.|.|.|.|.|.|.|.|.|.|.|.|.|.|.|,.|.|.|.|.|.|.|.|.|.|.|.|.|.|.|.|,.|.|.|.|.|.|.|.|.|.|.|.|.|.|.|.|,F|.|.|W|.|.|.|.|.|.|.|.|.|.|.|.|,.|.|.|W|.|.|.|.|.|.|.|.|.|.|.|.|,.|.|.|.|.|.|.|.|.|.|.|.|.|.|.|.|,.|.|.|.|.|.|.|.|.|.|.|.|.|.|.|.|,.|.|.|.|.|.|.|.|.|.|.|.|.|.|.|.|,.|.|.|.|.|.|.|.|.|.|.|.|.|.|.|.|,.|.|.|.|.|.|.|.|.|.|.|.|.|.|.|.|,.|.|.|.|.|.|.|.|.|.|.|.|.|.|.|.|,.|.|.|.|.|.|.|.|.|.|.|.|.|.|.|.|,.|.|.|.|.|.|.|.|.|.|.|.|.|.|.|.|,.|.|.|.|.|.|.|.|.|.|.|.|.|.|.|.|,.|.|.|.|.|.|.|.|.|.|.|.|.|.|.|.|,.|.|.|.|.|.|.|.|.|.|.|.|.|.|.|.|,.|.|.|.|.|.|.|.|.|.|.|.|.|.|.|.|,.|.|.|.|.|.|.|.|.|.|.|.|.|.|.|.|,.|.|.|.|.|.|.|.|.|.|.|.|.|.|.|.|,.|.|.|.|.|.|.|.|.|.|.|.|.|.|.|.|
.|.|.|.|.|.|.|.|.|.|.|.|.|.|.|.|,.|.|.|.|.|.|.|.|.|.|.|.|.|.|.|.|,.|.|.|.|.|.|.|.|.|.|.|.|.|.|.|.|,.|.|.|.|.|.|.|.|.|.|.|.|.|.|.|.|,.|.|.|.|.|.|.|.|.|.|.|.|.|.|.|.|,.|.|.|.|.|.|.|.|.|.|.|.|.|.|.|.|,.|.|.|.|.|.|.|.|.|.|.|.|.|.|.|.|,F|W|.|W|.|.|.|.|.|.|.|.|.|.|.|.|,F|W|.|.|.|.|.|.|.|.|.|.|.|.|.|.|,F|W|.|.|.|0|C|.|.|.|.|.|.|.|.|.|,F|W|.|.|.|.|.|.|.|.|.|.|.|.|.|.|,F|.|.|.|.|.|.|.|.|.|.|.|.|.|.|.|,F|W|.|.|.|0|C|.|.|.|.|.|.|.|.|.|,.|.|.|W|.|.|.|.|.|.|.|.|.|.|.|.|,.|.|.|.|.|.|.|.|.|.|.|.|.|.|.|.|,.|.|.|.|.|.|.|.|.|.|.|.|.|.|.|.|,.|.|.|.|.|.|.|.|.|.|.|.|.|.|.|.|,.|.|.|.|.|.|.|.|.|.|.|.|.|.|.|.|,.|.|.|.|.|.|.|.|.|.|.|.|.|.|.|.|,.|.|.|.|.|.|.|.|.|.|.|.|.|.|.|.|,.|.|.|.|.|.|.|.|.|.|.|.|.|.|.|.|,.|.|.|.|.|.|.|.|.|.|.|.|.|.|.|.|,.|.|.|.|.|.|.|.|.|.|.|.|.|.|.|.|,.|.|.|.|.|.|.|.|.|.|.|.|.|.|.|.|,.|.|.|.|.|.|.|.|.|.|.|.|.|.|.|.|,.|.|.|.|.|.|.|.|.|.|.|.|.|.|.|.|,.|.|.|.|.|.|.|.|.|.|.|.|.|.|.|.|,.|.|.|.|.|.|.|.|.|.|.|.|.|.|.|.|
.|.|.|.|.|.|.|.|.|.|.|.|.|.|.|.|,.|.|.|.|.|.|.|.|.|.|.|.|.|.|.|.|,.|.|.|.|.|.|.|.|.|.|.|.|.|.|.|.|,.|.|.|.|.|.|.|.|.|.|.|.|.|.|.|.|,.|.|.|.|.|.|.|.|.|.|.|.|.|.|.|.|,.|.|.|.|.|.|.|.|.|.|.|.|.|.|.|.|,.|.|.|.|.|.|.|.|.|.|.|.|.|.|.|.|,F|.|.|W|.|.|.|.|.|.|.|.|.|.|.|.|,F|.|.|.|.|.|T|.|.|.|.|.|.|.|.|.|,F|.|.|.|.|.|T|.|.|.|.|.|.|.|.|.|,F|.|.|.|.|2|B|.|.|.|.|.|.|.|.|.|,F|.|.|.|.|1|.|1|C|.|.|.|.|.|.|.|,F|.|.|.|.|.|T|.|.|.|.|.|.|.|.|.|,.|.|.|W|.|.|.|.|.|.|.|.|.|.|.|.|,.|.|.|.|.|.|.|.|.|.|.|.|.|.|.|.|,.|.|.|.|.|.|.|.|.|.|.|.|.|.|.|.|,.|.|.|.|.|.|.|.|.|.|.|.|.|.|.|.|,.|.|.|.|.|.|.|.|.|.|.|.|.|.|.|.|,.|.|.|.|.|.|.|.|.|.|.|.|.|.|.|.|,.|.|.|.|.|.|.|.|.|.|.|.|.|.|.|.|,.|.|.|.|.|.|.|.|.|.|.|.|.|.|.|.|,.|.|.|.|.|.|.|.|.|.|.|.|.|.|.|.|,.|.|.|.|.|.|.|.|.|.|.|.|.|.|.|.|,.|.|.|.|.|.|.|.|.|.|.|.|.|.|.|.|,.|.|.|.|.|.|.|.|.|.|.|.|.|.|.|.|,.|.|.|.|.|.|.|.|.|.|.|.|.|.|.|.|,.|.|.|.|.|.|.|.|.|.|.|.|.|.|.|.|,.|.|.|.|.|.|.|.|.|.|.|.|.|.|.|.|
.|.|.|.|.|.|.|.|.|.|.|.|.|.|.|.|,.|.|.|.|.|.|.|.|.|.|.|.|.|.|.|.|,.|.|.|.|.|.|.|.|.|.|.|.|.|.|.|.|,.|.|.|.|.|.|.|.|.|.|.|.|.|.|.|.|,.|.|.|.|.|.|.|.|.|.|.|.|.|.|.|.|,.|.|.|.|.|.|.|.|.|.|.|.|.|.|.|.|,.|.|.|.|.|.|.|.|.|.|.|.|.|.|.|.|,F|.|.|W|.|.|.|.|.|.|.|.|.|.|.|.|,F|.|.|.|.|1|.|1|C|.|.|.|.|.|.|.|,F|.|.|.|.|.|.|.|.|.|.|.|.|.|.|.|,F|.|.|.|.|2|B|.|.|.|.|.|.|.|.|.|,F|.|.|.|.|.|.|.|.|.|.|.|.|.|.|.|,F|.|.|.|.|.|.|.|.|.|.|.|.|.|.|.|,.|.|.|W|.|.|.|.|.|.|.|.|.|.|.|.|,.|.|.|.|.|.|.|.|.|.|.|.|.|.|.|.|,.|.|.|.|.|.|.|.|.|.|.|.|.|.|.|.|,.|.|.|.|.|.|.|.|.|.|.|.|.|.|.|.|,.|.|.|.|.|.|.|.|.|.|.|.|.|.|.|.|,.|.|.|.|.|.|.|.|.|.|.|.|.|.|.|.|,.|.|.|.|.|.|.|.|.|.|.|.|.|.|.|.|,.|.|.|.|.|.|.|.|.|.|.|.|.|.|.|.|,.|.|.|.|.|.|.|.|.|.|.|.|.|.|.|.|,.|.|.|.|.|.|.|.|.|.|.|.|.|.|.|.|,.|.|.|.|.|.|.|.|.|.|.|.|.|.|.|.|,.|.|.|.|.|.|.|.|.|.|.|.|.|.|.|.|,.|.|.|.|.|.|.|.|.|.|.|.|.|.|.|.|,.|.|.|.|.|.|.|.|.|.|.|.|.|.|.|.|,.|.|.|.|.|.|.|.|.|.|.|.|.|.|.|.|
.|.|.|.|.|.|.|.|.|.|.|.|.|.|.|.|,F|W|.|W|.|0|B|.|.|.|.|.|.|.|.|.|,F|W|.|W|D|.|.|.|.|.|.|.|.|3|P|.|,F|W|.|.|.|.|.|.|.|.|.|.|.|.|.|.|,F|W|.|.|.|.|.|.|.|.|.|.|2|.|.|.|,F|W|.|.|.|.|.|.|.|.|.|.|.|.|.|.|,F|W|.|.|.|.|.|.|.|.|.|.|.|.|.|.|,F|.|.|.|.|.|.|.|.|.|.|.|3|.|.|.|,F|.|.|.|.|.|.|.|.|.|.|.|.|.|.|.|,F|.|.|.|.|.|.|.|.|.|.|.|.|.|.|.|,F|.|.|.|.|2|B|.|.|.|.|.|.|.|.|.|,F|.|.|.|.|.|.|.|.|.|.|.|.|.|.|.|,F|.|.|.|.|.|.|1|D|.|.|.|.|.|.|.|,.|.|.|W|.|.|.|.|.|.|.|.|.|.|.|.|,.|.|.|.|.|.|.|.|.|.|.|.|.|.|.|.|,.|.|.|.|.|.|.|.|.|.|.|.|.|.|.|.|,.|.|.|.|.|.|.|.|.|.|.|.|.|.|.|.|,.|.|.|.|.|.|.|.|.|.|.|.|.|.|.|.|,.|.|.|.|.|.|.|.|.|.|.|.|.|.|.|.|,.|.|.|.|.|.|.|.|.|.|.|.|.|.|.|.|,.|.|.|.|.|.|.|.|.|.|.|.|.|.|.|.|,.|.|.|.|.|.|.|.|.|.|.|.|.|.|.|.|,.|.|.|.|.|.|.|.|.|.|.|.|.|.|.|.|,.|.|.|.|.|.|.|.|.|.|.|.|.|.|.|.|,.|.|.|.|.|.|.|.|.|.|.|.|.|.|.|.|,.|.|.|.|.|.|.|.|.|.|.|.|.|.|.|.|,.|.|.|.|.|.|.|.|.|.|.|.|.|.|.|.|,.|.|.|.|.|.|.|.|.|.|.|.|.|.|.|.|
.|.|.|.|.|.|.|.|.|.|.|.|.|.|.|.|,.|W|.|.|.|.|.|.|.|.|.|.|.|.|.|.|,.|W|.|.|.|.|.|.|.|.|.|.|.|.|.|.|,.|W|.|.|.|.|.|.|.|.|.|.|.|.|.|.|,F|.|.|W|.|.|.|.|.|.|.|.|.|.|.|.|,.|W|.|W|.|.|.|.|.|.|.|.|.|.|.|.|,.|W|.|.|.|.|.|.|.|.|.|.|.|.|.|.|,F|.|.|W|.|.|.|.|.|.|.|.|.|.|.|.|,F|.|.|.|.|1|.|1|C|.|.|.|.|.|.|.|,F|.|.|.|.|.|.|.|.|.|.|.|.|.|.|.|,F|.|.|.|.|2|B|.|.|.|.|.|.|.|.|.|,F|.|.|.|.|.|.|.|.|.|.|.|.|.|.|.|,F|.|.|.|.|.|.|.|.|.|.|.|.|.|.|.|,.|.|.|W|.|.|.|.|.|.|.|.|.|.|.|.|,.|.|.|.|.|.|.|.|.|.|.|.|.|.|.|.|,.|.|.|.|.|.|.|.|.|.|.|.|.|.|.|.|,.|.|.|.|.|.|.|.|.|.|.|.|.|.|.|.|,.|.|.|.|.|.|.|.|.|.|.|.|.|.|.|.|,.|.|.|.|.|.|.|.|.|.|.|.|.|.|.|.|,.|.|.|.|.|.|.|.|.|.|.|.|.|.|.|.|,.|.|.|.|.|.|.|.|.|.|.|.|.|.|.|.|,.|.|.|.|.|.|.|.|.|.|.|.|.|.|.|.|,.|.|.|.|.|.|.|.|.|.|.|.|.|.|.|.|,.|.|.|.|.|.|.|.|.|.|.|.|.|.|.|.|,.|.|.|.|.|.|.|.|.|.|.|.|.|.|.|.|,.|.|.|.|.|.|.|.|.|.|.|.|.|.|.|.|,.|.|.|.|.|.|.|.|.|.|.|.|.|.|.|.|,.|.|.|.|.|.|.|.|.|.|.|.|.|.|.|.|
.|.|.|.|.|.|.|.|.|.|.|.|.|.|.|.|,.|.|.|.|.|.|.|.|.|.|.|.|.|.|.|.|,F|W|.|W|.|.|.|.|.|.|.|.|.|.|.|.|,F|W|.|.|.|3|.|3|G|.|.|.|.|.|.|.|,F|.|.|.|.|.|.|.|.|.|.|.|.|.|.|.|,.|.|.|W|.|.|.|.|.|.|.|.|.|.|.|.|,.|.|.|.|.|.|.|.|.|.|.|.|.|.|.|.|,F|.|.|W|.|.|.|.|.|.|.|.|.|.|.|.|,F|.|.|.|.|.|T|.|.|.|.|.|.|.|.|.|,F|.|.|.|.|.|T|.|.|.|.|.|.|.|.|.|,F|.|.|.|.|2|B|.|.|.|.|.|.|.|.|.|,F|.|.|.|.|1|.|1|C|.|.|.|.|.|.|.|,F|.|.|.|.|.|T|.|.|.|.|.|.|.|.|.|,.|.|.|W|.|.|.|.|.|.|.|.|.|.|.|.|,.|.|.|.|.|.|.|.|.|.|.|.|.|.|.|.|,.|.|.|.|.|.|.|.|.|.|.|.|.|.|.|.|,.|.|.|.|.|.|.|.|.|.|.|.|.|.|.|.|,.|.|.|.|.|.|.|.|.|.|.|.|.|.|.|.|,.|.|.|.|.|.|.|.|.|.|.|.|.|.|.|.|,.|.|.|.|.|.|.|.|.|.|.|.|.|.|.|.|,.|.|.|.|.|.|.|.|.|.|.|.|.|.|.|.|,.|.|.|.|.|.|.|.|.|.|.|.|.|.|.|.|,.|.|.|.|.|.|.|.|.|.|.|.|.|.|.|.|,.|.|.|.|.|.|.|.|.|.|.|.|.|.|.|.|,.|.|.|.|.|.|.|.|.|.|.|.|.|.|.|.|,.|.|.|.|.|.|.|.|.|.|.|.|.|.|.|.|,.|.|.|.|.|.|.|.|.|.|.|.|.|.|.|.|,.|.|.|.|.|.|.|.|.|.|.|.|.|.|.|.|
.|.|.|.|.|.|.|.|.|.|.|.|.|.|.|.|,.|.|.|.|.|.|.|.|.|.|.|.|.|.|.|.|,F|.|.|W|.|.|.|.|.|.|.|.|.|.|.|.|,F|.|.|.|.|.|.|.|.|.|.|.|.|.|.|.|,F|.|.|.|.|2|.|2|G|.|.|.|.|.|.|.|,.|.|.|W|.|.|.|.|.|.|.|.|.|.|.|.|,.|.|.|.|.|.|.|.|.|.|.|.|.|.|.|.|,F|.|.|W|.|.|C|.|.|.|.|.|.|.|.|.|,F|.|.|.|.|.|.|.|.|.|.|.|.|.|.|.|,F|.|.|.|.|.|.|.|.|.|.|.|.|.|.|.|,F|.|.|.|.|.|.|.|.|.|.|.|.|.|.|.|,F|.|.|.|.|.|.|.|.|.|.|.|.|.|.|.|,F|.|.|.|.|2|C|.|.|.|.|.|.|.|.|.|,.|.|.|W|.|.|.|.|.|.|.|.|.|.|.|.|,.|.|.|.|.|.|.|.|.|.|.|.|.|.|.|.|,.|.|.|.|.|.|.|.|.|.|.|.|.|.|.|.|,.|.|.|.|.|.|.|.|.|.|.|.|.|.|.|.|,.|.|.|.|.|.|.|.|.|.|.|.|.|.|.|.|,.|.|.|.|.|.|.|.|.|.|.|.|.|.|.|.|,.|.|.|.|.|.|.|.|.|.|.|.|.|.|.|.|,.|.|.|.|.|.|.|.|.|.|.|.|.|.|.|.|,.|.|.|.|.|.|.|.|.|.|.|.|.|.|.|.|,.|.|.|.|.|.|.|.|.|.|.|.|.|.|.|.|,.|.|.|.|.|.|.|.|.|.|.|.|.|.|.|.|,.|.|.|.|.|.|.|.|.|.|.|.|.|.|.|.|,.|.|.|.|.|.|.|.|.|.|.|.|.|.|.|.|,.|.|.|.|.|.|.|.|.|.|.|.|.|.|.|.|,.|.|.|.|.|.|.|.|.|.|.|.|.|.|.|.|
.|.|.|.|.|.|.|.|.|.|.|.|.|.|.|.|,.|.|.|.|.|.|.|.|.|.|.|.|.|.|.|.|,.|W|.|.|.|.|.|.|.|.|.|.|.|.|.|.|,.|W|.|.|.|.|.|.|.|.|.|.|.|.|.|.|,.|W|.|.|.|.|.|.|.|.|.|.|.|.|.|.|,.|.|.|.|.|.|.|.|.|.|.|.|.|.|.|.|,.|.|.|.|.|.|.|.|.|.|.|.|.|.|.|.|,.|W|.|.|.|.|.|.|.|.|.|.|.|.|.|.|,.|W|.|.|.|.|.|.|.|.|.|.|.|.|.|.|,.|W|.|.|.|.|.|.|.|.|.|.|.|.|.|.|,.|W|.|.|.|.|.|.|.|.|.|.|.|.|.|.|,.|W|.|.|.|.|.|.|.|.|.|.|.|.|.|.|,.|W|.|.|.|.|.|.|.|.|.|.|.|.|.|.|,.|.|.|.|.|.|.|.|.|.|.|.|.|.|.|.|,.|.|.|.|.|.|.|.|.|.|.|.|.|.|.|.|,.|.|.|.|.|.|.|.|.|.|.|.|.|.|.|.|,.|.|.|.|.|.|.|.|.|.|.|.|.|.|.|.|,.|.|.|.|.|.|.|.|.|.|.|.|.|.|.|.|,.|.|.|.|.|.|.|.|.|.|.|.|.|.|.|.|,.|.|.|.|.|.|.|.|.|.|.|.|.|.|.|.|,.|.|.|.|.|.|.|.|.|.|.|.|.|.|.|.|,.|.|.|.|.|.|.|.|.|.|.|.|.|.|.|.|,.|.|.|.|.|.|.|.|.|.|.|.|.|.|.|.|,.|.|.|.|.|.|.|.|.|.|.|.|.|.|.|.|,.|.|.|.|.|.|.|.|.|.|.|.|.|.|.|.|,.|.|.|.|.|.|.|.|.|.|.|.|.|.|.|.|,.|.|.|.|.|.|.|.|.|.|.|.|.|.|.|.|,.|.|.|.|.|.|.|.|.|.|.|.|.|.|.|.|
.|.|.|.|.|.|.|.|.|.|.|.|.|.|.|.|,.|.|.|.|.|.|.|.|.|.|.|.|.|.|.|.|,.|.|.|.|.|.|.|.|.|.|.|.|.|.|.|.|,.|.|.|.|.|.|.|.|.|.|.|.|.|.|.|.|,.|.|.|.|.|.|.|.|.|.|.|.|.|.|.|.|,.|.|.|.|.|.|.|.|.|.|.|.|.|.|.|.|,.|.|.|.|.|.|.|.|.|.|.|.|.|.|.|.|,.|.|.|.|.|.|.|.|.|.|.|.|.|.|.|.|,.|.|.|.|.|.|.|.|.|.|.|.|.|.|.|.|,.|.|.|.|.|.|.|.|.|.|.|.|.|.|.|.|,.|.|.|.|.|.|.|.|.|.|.|.|.|.|.|.|,.|.|.|.|.|.|.|.|.|.|.|.|.|.|.|.|,.|.|.|.|.|.|.|.|.|.|.|.|.|.|.|.|,.|.|.|.|.|.|.|.|.|.|.|.|.|.|.|.|,.|.|.|.|.|.|.|.|.|.|.|.|.|.|.|.|,.|.|.|.|.|.|.|.|.|.|.|.|.|.|.|.|,.|.|.|.|.|.|.|.|.|.|.|.|.|.|.|.|,.|.|.|.|.|.|.|.|.|.|.|.|.|.|.|.|,.|.|.|.|.|.|.|.|.|.|.|.|.|.|.|.|,.|.|.|.|.|.|.|.|.|.|.|.|.|.|.|.|,.|.|.|.|.|.|.|.|.|.|.|.|.|.|.|.|,.|.|.|.|.|.|.|.|.|.|.|.|.|.|.|.|,.|.|.|.|.|.|.|.|.|.|.|.|.|.|.|.|,.|.|.|.|.|.|.|.|.|.|.|.|.|.|.|.|,.|.|.|.|.|.|.|.|.|.|.|.|.|.|.|.|,.|.|.|.|.|.|.|.|.|.|.|.|.|.|.|.|,.|.|.|.|.|.|.|.|.|.|.|.|.|.|.|.|,.|.|.|.|.|.|.|.|.|.|.|.|.|.|.|.|
.|.|.|.|.|.|.|.|.|.|.|.|.|.|.|.|,.|.|.|.|.|.|.|.|.|.|.|.|.|.|.|.|,.|.|.|.|.|.|.|.|.|.|.|.|.|.|.|.|,.|.|.|.|.|.|.|.|.|.|.|.|.|.|.|.|,.|.|.|.|.|.|.|.|.|.|.|.|.|.|.|.|,.|.|.|.|.|.|.|.|.|.|.|.|.|.|.|.|,.|.|.|.|.|.|.|.|.|.|.|.|.|.|.|.|,.|.|.|.|.|.|.|.|.|.|.|.|.|.|.|.|,.|.|.|.|.|.|.|.|.|.|.|.|.|.|.|.|,.|.|.|.|.|.|.|.|.|.|.|.|.|.|.|.|,.|.|.|.|.|.|.|.|.|.|.|.|.|.|.|.|,.|.|.|.|.|.|.|.|.|.|.|.|.|.|.|.|,.|.|.|.|.|.|.|.|.|.|.|.|.|.|.|.|,.|.|.|.|.|.|.|.|.|.|.|.|.|.|.|.|,.|.|.|.|.|.|.|.|.|.|.|.|.|.|.|.|,.|.|.|.|.|.|.|.|.|.|.|.|.|.|.|.|,.|.|.|.|.|.|.|.|.|.|.|.|.|.|.|.|,.|.|.|.|.|.|.|.|.|.|.|.|.|.|.|.|,.|.|.|.|.|.|.|.|.|.|.|.|.|.|.|.|,.|.|.|.|.|.|.|.|.|.|.|.|.|.|.|.|,.|.|.|.|.|.|.|.|.|.|.|.|.|.|.|.|,.|.|.|.|.|.|.|.|.|.|.|.|.|.|.|.|,.|.|.|.|.|.|.|.|.|.|.|.|.|.|.|.|,.|.|.|.|.|.|.|.|.|.|.|.|.|.|.|.|,.|.|.|.|.|.|.|.|.|.|.|.|.|.|.|.|,.|.|.|.|.|.|.|.|.|.|.|.|.|.|.|.|,.|.|.|.|.|.|.|.|.|.|.|.|.|.|.|.|,.|.|.|.|.|.|.|.|.|.|.|.|.|.|.|.|
.|.|.|.|.|.|.|.|.|.|.|.|.|.|.|.|,.|.|.|.|.|.|.|.|.|.|.|.|.|.|.|.|,.|.|.|.|.|.|.|.|.|.|.|.|.|.|.|.|,.|.|.|.|.|.|.|.|.|.|.|.|.|.|.|.|,.|.|.|.|.|.|.|.|.|.|.|.|.|.|.|.|,.|.|.|.|.|.|.|.|.|.|.|.|.|.|.|.|,.|.|.|.|.|.|.|.|.|.|.|.|.|.|.|.|,.|.|.|.|.|.|.|.|.|.|.|.|.|.|.|.|,.|.|.|.|.|.|.|.|.|.|.|.|.|.|.|.|,.|.|.|.|.|.|.|.|.|.|.|.|.|.|.|.|,.|.|.|.|.|.|.|.|.|.|.|.|.|.|.|.|,.|.|.|.|.|.|.|.|.|.|.|.|.|.|.|.|,.|.|.|.|.|.|.|.|.|.|.|.|.|.|.|.|,.|.|.|.|.|.|.|.|.|.|.|.|.|.|.|.|,.|.|.|.|.|.|.|.|.|.|.|.|.|.|.|.|,.|.|.|.|.|.|.|.|.|.|.|.|.|.|.|.|,.|.|.|.|.|.|.|.|.|.|.|.|.|.|.|.|,.|.|.|.|.|.|.|.|.|.|.|.|.|.|.|.|,.|.|.|.|.|.|.|.|.|.|.|.|.|.|.|.|,.|.|.|.|.|.|.|.|.|.|.|.|.|.|.|.|,.|.|.|.|.|.|.|.|.|.|.|.|.|.|.|.|,.|.|.|.|.|.|.|.|.|.|.|.|.|.|.|.|,.|.|.|.|.|.|.|.|.|.|.|.|.|.|.|.|,.|.|.|.|.|.|.|.|.|.|.|.|.|.|.|.|,.|.|.|.|.|.|.|.|.|.|.|.|.|.|.|.|,.|.|.|.|.|.|.|.|.|.|.|.|.|.|.|.|,.|.|.|.|.|.|.|.|.|.|.|.|.|.|.|.|,.|.|.|.|.|.|.|.|.|.|.|.|.|.|.|.|
.|.|.|.|.|.|.|.|.|.|.|.|.|.|.|.|,.|.|.|.|.|.|.|.|.|.|.|.|.|.|.|.|,.|.|.|.|.|.|.|.|.|.|.|.|.|.|.|.|,.|.|.|.|.|.|.|.|.|.|.|.|.|.|.|.|,.|.|.|.|.|.|.|.|.|.|.|.|.|.|.|.|,.|.|.|.|.|.|.|.|.|.|.|.|.|.|.|.|,.|.|.|.|.|.|.|.|.|.|.|.|.|.|.|.|,.|.|.|.|.|.|.|.|.|.|.|.|.|.|.|.|,.|.|.|.|.|.|.|.|.|.|.|.|.|.|.|.|,.|.|.|.|.|.|.|.|.|.|.|.|.|.|.|.|,.|.|.|.|.|.|.|.|.|.|.|.|.|.|.|.|,.|.|.|.|.|.|.|.|.|.|.|.|.|.|.|.|,.|.|.|.|.|.|.|.|.|.|.|.|.|.|.|.|,.|.|.|.|.|.|.|.|.|.|.|.|.|.|.|.|,.|.|.|.|.|.|.|.|.|.|.|.|.|.|.|.|,.|.|.|.|.|.|.|.|.|.|.|.|.|.|.|.|,.|.|.|.|.|.|.|.|.|.|.|.|.|.|.|.|,.|.|.|.|.|.|.|.|.|.|.|.|.|.|.|.|,.|.|.|.|.|.|.|.|.|.|.|.|.|.|.|.|,.|.|.|.|.|.|.|.|.|.|.|.|.|.|.|.|,.|.|.|.|.|.|.|.|.|.|.|.|.|.|.|.|,.|.|.|.|.|.|.|.|.|.|.|.|.|.|.|.|,.|.|.|.|.|.|.|.|.|.|.|.|.|.|.|.|,.|.|.|.|.|.|.|.|.|.|.|.|.|.|.|.|,.|.|.|.|.|.|.|.|.|.|.|.|.|.|.|.|,.|.|.|.|.|.|.|.|.|.|.|.|.|.|.|.|,.|.|.|.|.|.|.|.|.|.|.|.|.|.|.|.|,.|.|.|.|.|.|.|.|.|.|.|.|.|.|.|.|
.|.|.|.|.|.|.|.|.|.|.|.|.|.|.|.|,.|.|.|.|.|.|.|.|.|.|.|.|.|.|.|.|,.|.|.|.|.|.|.|.|.|.|.|.|.|.|.|.|,.|.|.|.|.|.|.|.|.|.|.|.|.|.|.|.|,.|.|.|.|.|.|.|.|.|.|.|.|.|.|.|.|,.|.|.|.|.|.|.|.|.|.|.|.|.|.|.|.|,.|.|.|.|.|.|.|.|.|.|.|.|.|.|.|.|,.|.|.|.|.|.|.|.|.|.|.|.|.|.|.|.|,.|.|.|.|.|.|.|.|.|.|.|.|.|.|.|.|,.|.|.|.|.|.|.|.|.|.|.|.|.|.|.|.|,.|.|.|.|.|.|.|.|.|.|.|.|.|.|.|.|,.|.|.|.|.|.|.|.|.|.|.|.|.|.|.|.|,.|.|.|.|.|.|.|.|.|.|.|.|.|.|.|.|,.|.|.|.|.|.|.|.|.|.|.|.|.|.|.|.|,.|.|.|.|.|.|.|.|.|.|.|.|.|.|.|.|,.|.|.|.|.|.|.|.|.|.|.|.|.|.|.|.|,.|.|.|.|.|.|.|.|.|.|.|.|.|.|.|.|,.|.|.|.|.|.|.|.|.|.|.|.|.|.|.|.|,.|.|.|.|.|.|.|.|.|.|.|.|.|.|.|.|,.|.|.|.|.|.|.|.|.|.|.|.|.|.|.|.|,.|.|.|.|.|.|.|.|.|.|.|.|.|.|.|.|,.|.|.|.|.|.|.|.|.|.|.|.|.|.|.|.|,.|.|.|.|.|.|.|.|.|.|.|.|.|.|.|.|,.|.|.|.|.|.|.|.|.|.|.|.|.|.|.|.|,.|.|.|.|.|.|.|.|.|.|.|.|.|.|.|.|,.|.|.|.|.|.|.|.|.|.|.|.|.|.|.|.|,.|.|.|.|.|.|.|.|.|.|.|.|.|.|.|.|,.|.|.|.|.|.|.|.|.|.|.|.|.|.|.|.|
.|.|.|.|.|.|.|.|.|.|.|.|.|.|.|.|,.|.|.|.|.|.|.|.|.|.|.|.|.|.|.|.|,.|.|.|.|.|.|.|.|.|.|.|.|.|.|.|.|,.|.|.|.|.|.|.|.|.|.|.|.|.|.|.|.|,.|.|.|.|.|.|.|.|.|.|.|.|.|.|.|.|,.|.|.|.|.|.|.|.|.|.|.|.|.|.|.|.|,.|.|.|.|.|.|.|.|.|.|.|.|.|.|.|.|,.|.|.|.|.|.|.|.|.|.|.|.|.|.|.|.|,.|.|.|.|.|.|.|.|.|.|.|.|.|.|.|.|,.|.|.|.|.|.|.|.|.|.|.|.|.|.|.|.|,.|.|.|.|.|.|.|.|.|.|.|.|.|.|.|.|,.|.|.|.|.|.|.|.|.|.|.|.|.|.|.|.|,.|.|.|.|.|.|.|.|.|.|.|.|.|.|.|.|,.|.|.|.|.|.|.|.|.|.|.|.|.|.|.|.|,.|.|.|.|.|.|.|.|.|.|.|.|.|.|.|.|,.|.|.|.|.|.|.|.|.|.|.|.|.|.|.|.|,.|.|.|.|.|.|.|.|.|.|.|.|.|.|.|.|,.|.|.|.|.|.|.|.|.|.|.|.|.|.|.|.|,.|.|.|.|.|.|.|.|.|.|.|.|.|.|.|.|,.|.|.|.|.|.|.|.|.|.|.|.|.|.|.|.|,.|.|.|.|.|.|.|.|.|.|.|.|.|.|.|.|,.|.|.|.|.|.|.|.|.|.|.|.|.|.|.|.|,.|.|.|.|.|.|.|.|.|.|.|.|.|.|.|.|,.|.|.|.|.|.|.|.|.|.|.|.|.|.|.|.|,.|.|.|.|.|.|.|.|.|.|.|.|.|.|.|.|,.|.|.|.|.|.|.|.|.|.|.|.|.|.|.|.|,.|.|.|.|.|.|.|.|.|.|.|.|.|.|.|.|,.|.|.|.|.|.|.|.|.|.|.|.|.|.|.|.|
.|.|.|.|.|.|.|.|.|.|.|.|.|.|.|.|,.|.|.|.|.|.|.|.|.|.|.|.|.|.|.|.|,.|.|.|.|.|.|.|.|.|.|.|.|.|.|.|.|,.|.|.|.|.|.|.|.|.|.|.|.|.|.|.|.|,.|.|.|.|.|.|.|.|.|.|.|.|.|.|.|.|,.|.|.|.|.|.|.|.|.|.|.|.|.|.|.|.|,.|.|.|.|.|.|.|.|.|.|.|.|.|.|.|.|,.|.|.|.|.|.|.|.|.|.|.|.|.|.|.|.|,.|.|.|.|.|.|.|.|.|.|.|.|.|.|.|.|,.|.|.|.|.|.|.|.|.|.|.|.|.|.|.|.|,.|.|.|.|.|.|.|.|.|.|.|.|.|.|.|.|,.|.|.|.|.|.|.|.|.|.|.|.|.|.|.|.|,.|.|.|.|.|.|.|.|.|.|.|.|.|.|.|.|,.|.|.|.|.|.|.|.|.|.|.|.|.|.|.|.|,.|.|.|.|.|.|.|.|.|.|.|.|.|.|.|.|,.|.|.|.|.|.|.|.|.|.|.|.|.|.|.|.|,.|.|.|.|.|.|.|.|.|.|.|.|.|.|.|.|,.|.|.|.|.|.|.|.|.|.|.|.|.|.|.|.|,.|.|.|.|.|.|.|.|.|.|.|.|.|.|.|.|,.|.|.|.|.|.|.|.|.|.|.|.|.|.|.|.|,.|.|.|.|.|.|.|.|.|.|.|.|.|.|.|.|,.|.|.|.|.|.|.|.|.|.|.|.|.|.|.|.|,.|.|.|.|.|.|.|.|.|.|.|.|.|.|.|.|,.|.|.|.|.|.|.|.|.|.|.|.|.|.|.|.|,.|.|.|.|.|.|.|.|.|.|.|.|.|.|.|.|,.|.|.|.|.|.|.|.|.|.|.|.|.|.|.|.|,.|.|.|.|.|.|.|.|.|.|.|.|.|.|.|.|,.|.|.|.|.|.|.|.|.|.|.|.|.|.|.|.|
.|.|.|.|.|.|.|.|.|.|.|.|.|.|.|.|,.|.|.|.|.|.|.|.|.|.|.|.|.|.|.|.|,.|.|.|.|.|.|.|.|.|.|.|.|.|.|.|.|,.|.|.|.|.|.|.|.|.|.|.|.|.|.|.|.|,.|.|.|.|.|.|.|.|.|.|.|.|.|.|.|.|,.|.|.|.|.|.|.|.|.|.|.|.|.|.|.|.|,.|.|.|.|.|.|.|.|.|.|.|.|.|.|.|.|,.|.|.|.|.|.|.|.|.|.|.|.|.|.|.|.|,.|.|.|.|.|.|.|.|.|.|.|.|.|.|.|.|,.|.|.|.|.|.|.|.|.|.|.|.|.|.|.|.|,.|.|.|.|.|.|.|.|.|.|.|.|.|.|.|.|,.|.|.|.|.|.|.|.|.|.|.|.|.|.|.|.|,.|.|.|.|.|.|.|.|.|.|.|.|.|.|.|.|,.|.|.|.|.|.|.|.|.|.|.|.|.|.|.|.|,.|.|.|.|.|.|.|.|.|.|.|.|.|.|.|.|,.|.|.|.|.|.|.|.|.|.|.|.|.|.|.|.|,.|.|.|.|.|.|.|.|.|.|.|.|.|.|.|.|,.|.|.|.|.|.|.|.|.|.|.|.|.|.|.|.|,.|.|.|.|.|.|.|.|.|.|.|.|.|.|.|.|,.|.|.|.|.|.|.|.|.|.|.|.|.|.|.|.|,.|.|.|.|.|.|.|.|.|.|.|.|.|.|.|.|,.|.|.|.|.|.|.|.|.|.|.|.|.|.|.|.|,.|.|.|.|.|.|.|.|.|.|.|.|.|.|.|.|,.|.|.|.|.|.|.|.|.|.|.|.|.|.|.|.|,.|.|.|.|.|.|.|.|.|.|.|.|.|.|.|.|,.|.|.|.|.|.|.|.|.|.|.|.|.|.|.|.|,.|.|.|.|.|.|.|.|.|.|.|.|.|.|.|.|,.|.|.|.|.|.|.|.|.|.|.|.|.|.|.|.|
.|.|.|.|.|.|.|.|.|.|.|.|.|.|.|.|,.|.|.|.|.|.|.|.|.|.|.|.|.|.|.|.|,.|.|.|.|.|.|.|.|.|.|.|.|.|.|.|.|,.|.|.|.|.|.|.|.|.|.|.|.|.|.|.|.|,.|.|.|.|.|.|.|.|.|.|.|.|.|.|.|.|,.|.|.|.|.|.|.|.|.|.|.|.|.|.|.|.|,.|.|.|.|.|.|.|.|.|.|.|.|.|.|.|.|,.|.|.|.|.|.|.|.|.|.|.|.|.|.|.|.|,.|.|.|.|.|.|.|.|.|.|.|.|.|.|.|.|,.|.|.|.|.|.|.|.|.|.|.|.|.|.|.|.|,.|.|.|.|.|.|.|.|.|.|.|.|.|.|.|.|,.|.|.|.|.|.|.|.|.|.|.|.|.|.|.|.|,.|.|.|.|.|.|.|.|.|.|.|.|.|.|.|.|,.|.|.|.|.|.|.|.|.|.|.|.|.|.|.|.|,.|.|.|.|.|.|.|.|.|.|.|.|.|.|.|.|,.|.|.|.|.|.|.|.|.|.|.|.|.|.|.|.|,.|.|.|.|.|.|.|.|.|.|.|.|.|.|.|.|,.|.|.|.|.|.|.|.|.|.|.|.|.|.|.|.|,.|.|.|.|.|.|.|.|.|.|.|.|.|.|.|.|,.|.|.|.|.|.|.|.|.|.|.|.|.|.|.|.|,.|.|.|.|.|.|.|.|.|.|.|.|.|.|.|.|,.|.|.|.|.|.|.|.|.|.|.|.|.|.|.|.|,.|.|.|.|.|.|.|.|.|.|.|.|.|.|.|.|,.|.|.|.|.|.|.|.|.|.|.|.|.|.|.|.|,.|.|.|.|.|.|.|.|.|.|.|.|.|.|.|.|,.|.|.|.|.|.|.|.|.|.|.|.|.|.|.|.|,.|.|.|.|.|.|.|.|.|.|.|.|.|.|.|.|,.|.|.|.|.|.|.|.|.|.|.|.|.|.|.|.|
.|.|.|.|.|.|.|.|.|.|.|.|.|.|.|.|,.|.|.|.|.|.|.|.|.|.|.|.|.|.|.|.|,.|.|.|.|.|.|.|.|.|.|.|.|.|.|.|.|,.|.|.|.|.|.|.|.|.|.|.|.|.|.|.|.|,.|.|.|.|.|.|.|.|.|.|.|.|.|.|.|.|,.|.|.|.|.|.|.|.|.|.|.|.|.|.|.|.|,.|.|.|.|.|.|.|.|.|.|.|.|.|.|.|.|,.|.|.|.|.|.|.|.|.|.|.|.|.|.|.|.|,.|.|.|.|.|.|.|.|.|.|.|.|.|.|.|.|,.|.|.|.|.|.|.|.|.|.|.|.|.|.|.|.|,.|.|.|.|.|.|.|.|.|.|.|.|.|.|.|.|,.|.|.|.|.|.|.|.|.|.|.|.|.|.|.|.|,.|.|.|.|.|.|.|.|.|.|.|.|.|.|.|.|,.|.|.|.|.|.|.|.|.|.|.|.|.|.|.|.|,.|.|.|.|.|.|.|.|.|.|.|.|.|.|.|.|,.|.|.|.|.|.|.|.|.|.|.|.|.|.|.|.|,.|.|.|.|.|.|.|.|.|.|.|.|.|.|.|.|,.|.|.|.|.|.|.|.|.|.|.|.|.|.|.|.|,.|.|.|.|.|.|.|.|.|.|.|.|.|.|.|.|,.|.|.|.|.|.|.|.|.|.|.|.|.|.|.|.|,.|.|.|.|.|.|.|.|.|.|.|.|.|.|.|.|,.|.|.|.|.|.|.|.|.|.|.|.|.|.|.|.|,.|.|.|.|.|.|.|.|.|.|.|.|.|.|.|.|,.|.|.|.|.|.|.|.|.|.|.|.|.|.|.|.|,.|.|.|.|.|.|.|.|.|.|.|.|.|.|.|.|,.|.|.|.|.|.|.|.|.|.|.|.|.|.|.|.|,.|.|.|.|.|.|.|.|.|.|.|.|.|.|.|.|,.|.|.|.|.|.|.|.|.|.|.|.|.|.|.|.|
