.|.|.|.|.|.|.|.|.|.|.|.|.|.|.|.|,.|.|.|.|.|.|.|.|.|.|.|.|.|.|.|.|,.|.|.|.|.|.|.|.|.|.|.|.|.|.|.|.|,.|.|.|.|.|.|.|.|.|.|.|.|.|.|.|.|,.|.|.|.|.|.|.|.|.|.|.|.|.|.|.|.|,.|.|.|.|.|.|.|.|.|.|.|.|.|.|.|.|,.|.|.|.|.|.|.|.|.|.|.|.|.|.|.|.|,.|.|.|.|.|.|.|.|.|.|.|.|.|.|.|.|,.|.|.|.|.|.|.|.|.|.|.|.|.|.|.|.|,.|.|.|.|.|.|.|.|.|.|.|.|.|.|.|.|,.|.|.|.|.|.|.|.|.|.|.|.|.|.|.|.|,.|.|.|.|.|.|.|.|.|.|.|.|.|.|.|.|,.|.|.|.|.|.|.|.|.|.|.|.|.|.|.|.|,.|.|.|.|.|.|.|.|.|.|.|.|.|.|.|.|,F|A|.|A|.|.|.|.|.|.|.|.|.|0|P|.|,.|.|.|A|.|.|.|.|.|.|.|.|.|.|.|.|,.|.|.|.|.|.|.|.|.|.|.|.|.|.|.|.|,.|.|.|.|.|.|.|.|.|.|.|.|.|.|.|.|,.|.|.|.|.|.|.|.|.|.|.|.|.|.|.|.|,.|.|.|.|.|.|.|.|.|.|.|.|.|.|.|.|,.|.|.|.|.|.|.|.|.|.|.|.|.|.|.|.|,.|.|.|.|.|.|.|.|.|.|.|.|.|.|.|.|,.|.|.|.|.|.|.|.|.|.|.|.|.|.|.|.|,.|.|.|.|.|.|.|.|.|.|.|.|.|.|.|.|,.|.|.|.|.|.|.|.|.|.|.|.|.|.|.|.|,.|.|.|.|.|.|.|.|.|.|.|.|.|.|.|.|,.|.|.|.|.|.|.|.|.|.|.|.|.|.|.|.|,.|.|.|.|.|.|.|.|.|.|.|.|.|.|.|.|
.|.|.|.|.|.|.|.|.|.|.|.|.|.|.|.|,.|.|.|.|.|.|.|.|.|.|.|.|.|.|.|.|,.|.|.|.|.|.|.|.|.|.|.|.|.|.|.|.|,.|.|.|.|.|.|.|.|.|.|.|.|.|.|.|.|,.|.|.|.|.|.|.|.|.|.|.|.|.|.|.|.|,.|.|.|.|.|.|.|.|.|.|.|.|.|.|.|.|,.|.|.|.|.|.|.|.|.|.|.|.|.|.|.|.|,F|W|.|W|.|.|.|.|.|.|.|.|.|.|.|.|,F|W|.|.|.|.|.|.|.|.|.|.|.|0|G|.|,F|W|.|.|.|.|.|.|.|.|.|.|.|.|.|.|,.|.|.|W|.|.|.|.|.|.|.|.|.|.|.|.|,.|.|.|.|.|.|.|.|.|.|.|.|.|.|.|.|,.|.|.|.|.|.|.|.|.|.|.|.|.|.|.|.|,.|.|.|.|.|.|.|.|.|.|.|.|.|.|.|.|,F|.|.|A|.|.|.|2|B|.|.|.|.|.|.|.|,F|A|.|.|.|.|.|1|B|.|.|.|.|.|.|.|,F|A|.|.|.|.|.|.|.|.|.|.|.|.|.|.|,.|.|.|A|.|.|.|.|.|.|.|.|.|.|.|.|,.|.|.|.|.|.|.|.|.|.|.|.|.|.|.|.|,.|.|.|.|.|.|.|.|.|.|.|.|.|.|.|.|,.|.|.|.|.|.|.|.|.|.|.|.|.|.|.|.|,.|.|.|.|.|.|.|.|.|.|.|.|.|.|.|.|,.|.|.|.|.|.|.|.|.|.|.|.|.|.|.|.|,.|.|.|.|.|.|.|.|.|.|.|.|.|.|.|.|,.|.|.|.|.|.|.|.|.|.|.|.|.|.|.|.|,.|.|.|.|.|.|.|.|.|.|.|.|.|.|.|.|,.|.|.|.|.|.|.|.|.|.|.|.|.|.|.|.|,.|.|.|.|.|.|.|.|.|.|.|.|.|.|.|.|
.|.|.|.|.|.|.|.|.|.|.|.|.|.|.|.|,.|.|.|.|.|.|.|.|.|.|.|.|.|.|.|.|,.|.|.|.|.|.|.|.|.|.|.|.|.|.|.|.|,.|.|.|.|.|.|.|.|.|.|.|.|.|.|.|.|,.|.|.|.|.|.|.|.|.|.|.|.|.|.|.|.|,.|.|.|.|.|.|.|.|.|.|.|.|.|.|.|.|,.|.|.|.|.|.|.|.|.|.|.|.|.|.|.|.|,F|.|.|W|.|.|.|.|.|.|.|.|2|.|.|.|,F|.|.|.|.|.|.|.|.|.|.|.|2|.|.|.|,F|.|.|.|.|.|.|.|.|.|.|.|2|.|.|.|,.|.|.|W|.|.|.|.|.|.|.|.|.|.|.|.|,.|.|.|.|.|.|.|.|.|.|.|.|.|.|.|.|,.|.|.|.|.|.|.|.|.|.|.|.|.|.|.|.|,.|.|.|.|.|.|.|.|.|.|.|.|.|.|.|.|,F|.|.|A|.|.|.|.|.|.|.|.|.|.|.|.|,F|.|.|.|.|.|.|.|.|.|.|.|.|.|.|.|,F|.|.|.|.|.|.|.|.|.|.|.|.|.|.|.|,.|.|.|A|.|.|.|.|.|.|.|.|.|.|.|.|,.|.|.|.|.|.|.|.|.|.|.|.|.|.|.|.|,.|.|.|.|.|.|.|.|.|.|.|.|.|.|.|.|,.|.|.|.|.|.|.|.|.|.|.|.|.|.|.|.|,.|.|.|.|.|.|.|.|.|.|.|.|.|.|.|.|,.|.|.|.|.|.|.|.|.|.|.|.|.|.|.|.|,.|.|.|.|.|.|.|.|.|.|.|.|.|.|.|.|,.|.|.|.|.|.|.|.|.|.|.|.|.|.|.|.|,.|.|.|.|.|.|.|.|.|.|.|.|.|.|.|.|,.|.|.|.|.|.|.|.|.|.|.|.|.|.|.|.|,.|.|.|.|.|.|.|.|.|.|.|.|.|.|.|.|
.|.|.|.|.|.|.|.|.|.|.|.|.|.|.|.|,.|.|.|.|.|.|.|.|.|.|.|.|.|.|.|.|,.|.|.|.|.|.|.|.|.|.|.|.|.|.|.|.|,.|.|.|.|.|.|.|.|.|.|.|.|.|.|.|.|,.|.|.|.|.|.|.|.|.|.|.|.|.|.|.|.|,.|.|.|.|.|.|.|.|.|.|.|.|.|.|.|.|,.|.|.|.|.|.|.|.|.|.|.|.|.|.|.|.|,F|.|.|W|.|.|.|.|.|.|.|.|.|.|.|.|,F|.|.|.|.|.|.|.|.|.|.|.|.|.|.|.|,F|.|.|.|.|.|.|.|.|.|.|.|.|.|.|.|,F|A|.|.|.|.|.|1|B|.|.|.|.|.|.|.|,F|A|.|.|.|.|.|.|.|.|.|.|.|.|.|.|,F|A|.|.|.|.|.|.|.|.|.|.|.|.|.|.|,F|A|.|.|.|.|.|.|.|.|.|.|.|.|.|.|,F|.|.|.|.|.|.|.|.|.|.|.|.|.|.|.|,F|A|.|.|.|.|.|.|.|.|.|.|.|.|.|.|,F|A|.|.|.|.|.|.|.|.|.|.|.|.|.|.|,.|.|.|A|.|.|.|.|.|.|.|.|.|.|.|.|,.|.|.|.|.|.|.|.|.|.|.|.|.|.|.|.|,.|.|.|.|.|.|.|.|.|.|.|.|.|.|.|.|,.|.|.|.|.|.|.|.|.|.|.|.|.|.|.|.|,.|.|.|.|.|.|.|.|.|.|.|.|.|.|.|.|,.|.|.|.|.|.|.|.|.|.|.|.|.|.|.|.|,.|.|.|.|.|.|.|.|.|.|.|.|.|.|.|.|,.|.|.|.|.|.|.|.|.|.|.|.|.|.|.|.|,.|.|.|.|.|.|.|.|.|.|.|.|.|.|.|.|,.|.|.|.|.|.|.|.|.|.|.|.|.|.|.|.|,.|.|.|.|.|.|.|.|.|.|.|.|.|.|.|.|
.|.|.|.|.|.|.|.|.|.|.|.|.|.|.|.|,.|.|.|.|.|.|.|.|.|.|.|.|.|.|.|.|,.|.|.|.|.|.|.|.|.|.|.|.|.|.|.|.|,.|.|.|.|.|.|.|.|.|.|.|.|.|.|.|.|,.|.|.|.|.|.|.|.|.|.|.|.|.|.|.|.|,.|.|.|.|.|.|.|.|.|.|.|.|.|.|.|.|,.|.|.|.|.|.|.|.|.|.|.|.|.|.|.|.|,F|.|.|W|.|.|.|.|.|.|.|.|.|.|.|.|,F|.|.|.|.|.|.|.|.|.|.|.|.|.|.|.|,F|.|.|.|.|.|.|2|B|.|.|.|.|.|.|.|,.|A|.|W|.|.|.|.|.|.|.|.|.|.|.|.|,.|A|.|.|.|.|.|.|.|.|.|.|.|.|.|.|,F|A|.|A|.|.|.|3|B|.|.|.|.|.|.|.|,F|.|.|.|.|.|.|.|.|.|.|.|.|.|.|.|,F|A|.|A|.|3|M|.|.|.|.|.|.|.|.|.|,F|A|.|.|.|.|D|.|.|.|.|.|.|.|.|.|,F|.|.|.|.|.|.|.|.|.|.|.|.|.|.|.|,.|.|.|A|.|.|.|.|.|.|.|.|.|.|.|.|,.|.|.|.|.|.|.|.|.|.|.|.|.|.|.|.|,.|.|.|.|.|.|.|.|.|.|.|.|.|.|.|.|,.|.|.|.|.|.|.|.|.|.|.|.|.|.|.|.|,.|.|.|.|.|.|.|.|.|.|.|.|.|.|.|.|,.|.|.|.|.|.|.|.|.|.|.|.|.|.|.|.|,.|.|.|.|.|.|.|.|.|.|.|.|.|.|.|.|,.|.|.|.|.|.|.|.|.|.|.|.|.|.|.|.|,.|.|.|.|.|.|.|.|.|.|.|.|.|.|.|.|,.|.|.|.|.|.|.|.|.|.|.|.|.|.|.|.|,.|.|.|.|.|.|.|.|.|.|.|.|.|.|.|.|
.|.|.|.|.|.|.|.|.|.|.|.|.|.|.|.|,.|.|.|.|.|.|.|.|.|.|.|.|.|.|.|.|,.|.|.|.|.|.|.|.|.|.|.|.|.|.|.|.|,.|.|.|.|.|.|.|.|.|.|.|.|.|.|.|.|,.|.|.|.|.|.|.|.|.|.|.|.|.|.|.|.|,.|.|.|.|.|.|.|.|.|.|.|.|.|.|.|.|,.|.|.|.|.|.|.|.|.|.|.|.|.|.|.|.|,F|.|.|W|.|.|.|.|.|.|.|.|.|.|.|.|,F|.|.|.|.|.|.|.|.|.|.|.|.|.|.|.|,F|.|.|.|.|.|.|.|.|.|.|.|.|.|.|.|,.|.|.|W|.|.|.|.|.|.|.|.|.|.|.|.|,.|.|.|.|.|.|.|.|.|.|.|.|.|.|.|.|,F|.|.|A|.|.|.|.|.|.|.|.|.|.|.|.|,F|.|.|.|.|.|.|.|.|.|.|.|.|.|.|.|,F|.|.|A|.|.|.|.|.|.|B|.|.|.|.|.|,F|.|.|.|.|.|.|.|.|.|.|.|.|.|.|.|,F|.|.|.|.|.|.|.|.|.|.|.|.|.|.|.|,.|.|.|A|.|.|.|.|.|.|.|.|.|.|.|.|,.|.|.|.|.|.|.|.|.|.|.|.|.|.|.|.|,.|.|.|.|.|.|.|.|.|.|.|.|.|.|.|.|,.|.|.|.|.|.|.|.|.|.|.|.|.|.|.|.|,.|.|.|.|.|.|.|.|.|.|.|.|.|.|.|.|,.|.|.|.|.|.|.|.|.|.|.|.|.|.|.|.|,.|.|.|.|.|.|.|.|.|.|.|.|.|.|.|.|,.|.|.|.|.|.|.|.|.|.|.|.|.|.|.|.|,.|.|.|.|.|.|.|.|.|.|.|.|.|.|.|.|,.|.|.|.|.|.|.|.|.|.|.|.|.|.|.|.|,.|.|.|.|.|.|.|.|.|.|.|.|.|.|.|.|
.|.|.|.|.|.|.|.|.|.|.|.|.|.|.|.|,.|.|.|.|.|.|.|.|.|.|.|.|.|.|.|.|,.|.|.|.|.|.|.|.|.|.|.|.|.|.|.|.|,.|.|.|.|.|.|.|.|.|.|.|.|.|.|.|.|,.|.|.|.|.|.|.|.|.|.|.|.|.|.|.|.|,.|.|.|.|.|.|.|.|.|.|.|.|.|.|.|.|,.|.|.|.|.|.|.|.|.|.|.|.|.|.|.|.|,F|.|.|W|.|.|.|.|.|.|.|.|.|.|.|.|,F|.|.|.|.|.|.|.|.|.|.|.|.|.|.|.|,F|.|.|.|.|.|.|.|.|.|.|.|.|.|.|.|,.|.|.|W|.|.|.|.|.|.|.|.|.|.|.|.|,.|.|.|.|.|.|.|.|.|.|.|.|.|.|.|.|,.|A|.|.|.|.|.|.|.|.|.|.|.|.|.|.|,.|A|.|.|.|.|.|.|.|.|.|.|.|.|.|.|,.|A|.|.|.|.|.|.|.|.|.|.|.|.|.|.|,.|A|.|.|.|.|.|.|.|.|.|.|.|.|.|.|,.|A|.|.|.|.|.|.|.|.|.|.|.|.|.|.|,.|.|.|.|.|.|.|.|.|.|.|.|.|.|.|.|,.|.|.|.|.|.|.|.|.|.|.|.|.|.|.|.|,.|.|.|.|.|.|.|.|.|.|.|.|.|.|.|.|,.|.|.|.|.|.|.|.|.|.|.|.|.|.|.|.|,.|.|.|.|.|.|.|.|.|.|.|.|.|.|.|.|,.|.|.|.|.|.|.|.|.|.|.|.|.|.|.|.|,.|.|.|.|.|.|.|.|.|.|.|.|.|.|.|.|,.|.|.|.|.|.|.|.|.|.|.|.|.|.|.|.|,.|.|.|.|.|.|.|.|.|.|.|.|.|.|.|.|,.|.|.|.|.|.|.|.|.|.|.|.|.|.|.|.|,.|.|.|.|.|.|.|.|.|.|.|.|.|.|.|.|
.|.|.|.|.|.|.|.|.|.|.|.|.|.|.|.|,.|.|.|.|.|.|.|.|.|.|.|.|.|.|.|.|,.|.|.|.|.|.|.|.|.|.|.|.|.|.|.|.|,.|.|.|.|.|.|.|.|.|.|.|.|.|.|.|.|,.|.|.|.|.|.|.|.|.|.|.|.|.|.|.|.|,.|.|.|.|.|.|.|.|.|.|.|.|.|.|.|.|,.|.|.|.|.|.|.|.|.|.|.|.|.|.|.|.|,F|.|.|W|.|.|.|.|.|.|.|.|.|.|.|.|,F|.|.|.|.|.|.|.|.|.|.|.|.|.|.|.|,F|.|.|.|.|.|.|.|.|.|.|.|.|.|.|.|,.|.|.|W|.|.|.|.|.|.|.|.|.|.|.|.|,.|.|.|.|.|.|.|.|.|.|.|.|.|.|.|.|,.|.|.|.|.|.|.|.|.|.|.|.|.|.|.|.|,.|.|.|.|.|.|.|.|.|.|.|.|.|.|.|.|,.|.|.|.|.|.|.|.|.|.|.|.|.|.|.|.|,.|.|.|.|.|.|.|.|.|.|.|.|.|.|.|.|,.|.|.|.|.|.|.|.|.|.|.|.|.|.|.|.|,.|.|.|.|.|.|.|.|.|.|.|.|.|.|.|.|,.|.|.|.|.|.|.|.|.|.|.|.|.|.|.|.|,.|.|.|.|.|.|.|.|.|.|.|.|.|.|.|.|,.|.|.|.|.|.|.|.|.|.|.|.|.|.|.|.|,.|.|.|.|.|.|.|.|.|.|.|.|.|.|.|.|,.|.|.|.|.|.|.|.|.|.|.|.|.|.|.|.|,.|.|.|.|.|.|.|.|.|.|.|.|.|.|.|.|,.|.|.|.|.|.|.|.|.|.|.|.|.|.|.|.|,.|.|.|.|.|.|.|.|.|.|.|.|.|.|.|.|,.|.|.|.|.|.|.|.|.|.|.|.|.|.|.|.|,.|.|.|.|.|.|.|.|.|.|.|.|.|.|.|.|
.|.|.|.|.|.|.|.|.|.|.|.|.|.|.|.|,.|.|.|.|.|.|.|.|.|.|.|.|.|.|.|.|,.|.|.|.|.|.|.|.|.|.|.|.|.|.|.|.|,.|.|.|.|.|.|.|.|.|.|.|.|.|.|.|.|,.|.|.|.|.|.|.|.|.|.|.|.|.|.|.|.|,.|.|.|.|.|.|.|.|.|.|.|.|.|.|.|.|,.|.|.|.|.|.|.|.|.|.|.|.|.|.|.|.|,F|.|.|W|.|.|.|.|.|.|.|.|.|.|.|.|,F|.|.|.|.|.|.|.|.|.|.|.|.|.|.|.|,F|.|.|.|.|.|.|.|.|.|.|.|.|.|.|.|,.|.|.|W|.|.|.|.|.|.|.|.|.|.|.|.|,.|.|.|.|.|.|.|.|.|.|.|.|.|.|.|.|,.|.|.|.|.|.|.|.|.|.|.|.|.|.|.|.|,.|.|.|.|.|.|.|.|.|.|.|.|.|.|.|.|,.|.|.|.|.|.|.|.|.|.|.|.|.|.|.|.|,.|.|.|.|.|.|.|.|.|.|.|.|.|.|.|.|,.|.|.|.|.|.|.|.|.|.|.|.|.|.|.|.|,.|.|.|.|.|.|.|.|.|.|.|.|.|.|.|.|,.|.|.|.|.|.|.|.|.|.|.|.|.|.|.|.|,.|.|.|.|.|.|.|.|.|.|.|.|.|.|.|.|,.|.|.|.|.|.|.|.|.|.|.|.|.|.|.|.|,.|.|.|.|.|.|.|.|.|.|.|.|.|.|.|.|,.|.|.|.|.|.|.|.|.|.|.|.|.|.|.|.|,.|.|.|.|.|.|.|.|.|.|.|.|.|.|.|.|,.|.|.|.|.|.|.|.|.|.|.|.|.|.|.|.|,.|.|.|.|.|.|.|.|.|.|.|.|.|.|.|.|,.|.|.|.|.|.|.|.|.|.|.|.|.|.|.|.|,.|.|.|.|.|.|.|.|.|.|.|.|.|.|.|.|
.|.|.|.|.|.|.|.|.|.|.|.|.|.|.|.|,.|.|.|.|.|.|.|.|.|.|.|.|.|.|.|.|,.|.|.|.|.|.|.|.|.|.|.|.|.|.|.|.|,.|.|.|.|.|.|.|.|.|.|.|.|.|.|.|.|,.|.|.|.|.|.|.|.|.|.|.|.|.|.|.|.|,.|.|.|.|.|.|.|.|.|.|.|.|.|.|.|.|,.|.|.|.|.|.|.|.|.|.|.|.|.|.|.|.|,F|.|.|W|.|.|.|.|.|.|.|.|.|.|.|.|,F|.|.|.|.|.|.|.|.|.|.|.|.|.|.|.|,F|.|.|.|.|.|.|.|.|.|.|.|.|.|.|.|,.|.|.|W|.|.|.|.|.|.|.|.|.|.|.|.|,.|.|.|.|.|.|.|.|.|.|.|.|.|.|.|.|,.|.|.|.|.|.|.|.|.|.|.|.|.|.|.|.|,.|.|.|.|.|.|.|.|.|.|.|.|.|.|.|.|,.|.|.|.|.|.|.|.|.|.|.|.|.|.|.|.|,.|.|.|.|.|.|.|.|.|.|.|.|.|.|.|.|,.|.|.|.|.|.|.|.|.|.|.|.|.|.|.|.|,.|.|.|.|.|.|.|.|.|.|.|.|.|.|.|.|,.|.|.|.|.|.|.|.|.|.|.|.|.|.|.|.|,.|.|.|.|.|.|.|.|.|.|.|.|.|.|.|.|,.|.|.|.|.|.|.|.|.|.|.|.|.|.|.|.|,.|.|.|.|.|.|.|.|.|.|.|.|.|.|.|.|,.|.|.|.|.|.|.|.|.|.|.|.|.|.|.|.|,.|.|.|.|.|.|.|.|.|.|.|.|.|.|.|.|,.|.|.|.|.|.|.|.|.|.|.|.|.|.|.|.|,.|.|.|.|.|.|.|.|.|.|.|.|.|.|.|.|,.|.|.|.|.|.|.|.|.|.|.|.|.|.|.|.|,.|.|.|.|.|.|.|.|.|.|.|.|.|.|.|.|
.|.|.|.|.|.|.|.|.|.|.|.|.|.|.|.|,.|.|.|.|.|.|.|.|.|.|.|.|.|.|.|.|,.|.|.|.|.|.|.|.|.|.|.|.|.|.|.|.|,.|.|.|.|.|.|.|.|.|.|.|.|.|.|.|.|,.|.|.|.|.|.|.|.|.|.|.|.|.|.|.|.|,.|.|.|.|.|.|.|.|.|.|.|.|.|.|.|.|,.|.|.|.|.|.|.|.|.|.|.|.|.|.|.|.|,F|.|.|W|.|.|.|.|.|.|.|.|5|.|.|.|,F|.|.|.|.|.|.|.|.|.|.|.|5|.|.|.|,F|.|.|.|.|.|.|.|.|.|.|.|5|.|.|.|,.|.|.|W|.|.|.|.|.|.|.|.|.|.|.|.|,.|.|.|.|.|.|.|.|.|.|.|.|.|.|.|.|,.|.|.|.|.|.|.|.|.|.|.|.|.|.|.|.|,.|.|.|.|.|.|.|.|.|.|.|.|.|.|.|.|,.|.|.|.|.|.|.|.|.|.|.|.|.|.|.|.|,.|.|.|.|.|.|.|.|.|.|.|.|.|.|.|.|,.|.|.|.|.|.|.|.|.|.|.|.|.|.|.|.|,.|.|.|.|.|.|.|.|.|.|.|.|.|.|.|.|,.|.|.|.|.|.|.|.|.|.|.|.|.|.|.|.|,.|.|.|.|.|.|.|.|.|.|.|.|.|.|.|.|,.|.|.|.|.|.|.|.|.|.|.|.|.|.|.|.|,.|.|.|.|.|.|.|.|.|.|.|.|.|.|.|.|,.|.|.|.|.|.|.|.|.|.|.|.|.|.|.|.|,.|.|.|.|.|.|.|.|.|.|.|.|.|.|.|.|,.|.|.|.|.|.|.|.|.|.|.|.|.|.|.|.|,.|.|.|.|.|.|.|.|.|.|.|.|.|.|.|.|,.|.|.|.|.|.|.|.|.|.|.|.|.|.|.|.|,.|.|.|.|.|.|.|.|.|.|.|.|.|.|.|.|
.|.|.|.|.|.|.|.|.|.|.|.|.|.|.|.|,.|.|.|.|.|.|.|.|.|.|.|.|.|.|.|.|,.|.|.|.|.|.|.|.|.|.|.|.|.|.|.|.|,.|.|.|.|.|.|.|.|.|.|.|.|.|.|.|.|,.|.|.|.|.|.|.|.|.|.|.|.|.|.|.|.|,.|.|.|.|.|.|.|.|.|.|.|.|.|.|.|.|,.|.|.|.|.|.|.|.|.|.|.|.|.|.|.|.|,F|.|.|W|.|.|.|.|.|.|.|.|.|.|.|.|,F|.|.|.|.|.|.|.|.|.|.|.|.|.|.|.|,F|.|.|.|.|.|.|.|.|.|.|.|.|.|.|.|,.|.|.|W|.|.|.|.|.|.|.|.|.|.|.|.|,.|.|.|.|.|.|.|.|.|.|.|.|.|.|.|.|,.|.|.|.|.|.|.|.|.|.|.|.|.|.|.|.|,.|.|.|.|.|.|.|.|.|.|.|.|.|.|.|.|,.|.|.|.|.|.|.|.|.|.|.|.|.|.|.|.|,.|.|.|.|.|.|.|.|.|.|.|.|.|.|.|.|,.|.|.|.|.|.|.|.|.|.|.|.|.|.|.|.|,.|.|.|.|.|.|.|.|.|.|.|.|.|.|.|.|,.|.|.|.|.|.|.|.|.|.|.|.|.|.|.|.|,.|.|.|.|.|.|.|.|.|.|.|.|.|.|.|.|,.|.|.|.|.|.|.|.|.|.|.|.|.|.|.|.|,.|.|.|.|.|.|.|.|.|.|.|.|.|.|.|.|,.|.|.|.|.|.|.|.|.|.|.|.|.|.|.|.|,.|.|.|.|.|.|.|.|.|.|.|.|.|.|.|.|,.|.|.|.|.|.|.|.|.|.|.|.|.|.|.|.|,.|.|.|.|.|.|.|.|.|.|.|.|.|.|.|.|,.|.|.|.|.|.|.|.|.|.|.|.|.|.|.|.|,.|.|.|.|.|.|.|.|.|.|.|.|.|.|.|.|
.|.|.|.|.|.|.|.|.|.|.|.|.|.|.|.|,.|.|.|.|.|.|.|.|.|.|.|.|.|.|.|.|,.|.|.|.|.|.|.|.|.|.|.|.|.|.|.|.|,.|.|.|.|.|.|.|.|.|.|.|.|.|.|.|.|,.|.|.|.|.|.|.|.|.|.|.|.|.|.|.|.|,.|.|.|.|.|.|.|.|.|.|.|.|.|.|.|.|,.|.|.|.|.|.|.|.|.|.|.|.|.|.|.|.|,F|.|.|W|.|.|.|.|.|.|.|.|.|.|.|.|,F|.|.|.|.|.|.|.|.|.|.|.|.|.|.|.|,F|.|.|.|.|.|.|.|.|.|.|.|.|.|.|.|,.|.|.|W|.|.|.|.|.|.|.|.|.|.|.|.|,.|.|.|.|.|.|.|.|.|.|.|.|.|.|.|.|,.|.|.|.|.|.|.|.|.|.|.|.|.|.|.|.|,.|.|.|.|.|.|.|.|.|.|.|.|.|.|.|.|,.|.|.|.|.|.|.|.|.|.|.|.|.|.|.|.|,.|.|.|.|.|.|.|.|.|.|.|.|.|.|.|.|,.|.|.|.|.|.|.|.|.|.|.|.|.|.|.|.|,.|.|.|.|.|.|.|.|.|.|.|.|.|.|.|.|,.|.|.|.|.|.|.|.|.|.|.|.|.|.|.|.|,.|.|.|.|.|.|.|.|.|.|.|.|.|.|.|.|,.|.|.|.|.|.|.|.|.|.|.|.|.|.|.|.|,.|.|.|.|.|.|.|.|.|.|.|.|.|.|.|.|,.|.|.|.|.|.|.|.|.|.|.|.|.|.|.|.|,.|.|.|.|.|.|.|.|.|.|.|.|.|.|.|.|,.|.|.|.|.|.|.|.|.|.|.|.|.|.|.|.|,.|.|.|.|.|.|.|.|.|.|.|.|.|.|.|.|,.|.|.|.|.|.|.|.|.|.|.|.|.|.|.|.|,.|.|.|.|.|.|.|.|.|.|.|.|.|.|.|.|
.|.|.|.|.|.|.|.|.|.|.|.|.|.|.|.|,.|.|.|.|.|.|.|.|.|.|.|.|.|.|.|.|,.|.|.|.|.|.|.|.|.|.|.|.|.|.|.|.|,.|.|.|.|.|.|.|.|.|.|.|.|.|.|.|.|,.|.|.|.|.|.|.|.|.|.|.|.|.|.|.|.|,.|.|.|.|.|.|.|.|.|.|.|.|.|.|.|.|,.|.|.|.|.|.|.|.|.|.|.|.|.|.|.|.|,F|.|.|W|.|.|.|.|.|.|.|.|.|.|.|.|,F|.|.|.|.|.|.|.|.|.|.|.|.|.|.|.|,F|.|.|.|.|.|.|2|G|.|.|.|.|.|.|.|,.|.|.|W|.|.|.|.|.|.|.|.|.|.|.|.|,.|.|.|.|.|.|.|.|.|.|.|.|.|.|.|.|,.|.|.|.|.|.|.|.|.|.|.|.|.|.|.|.|,.|.|.|.|.|.|.|.|.|.|.|.|.|.|.|.|,.|.|.|.|.|.|.|.|.|.|.|.|.|.|.|.|,.|.|.|.|.|.|.|.|.|.|.|.|.|.|.|.|,.|.|.|.|.|.|.|.|.|.|.|.|.|.|.|.|,.|.|.|.|.|.|.|.|.|.|.|.|.|.|.|.|,.|.|.|.|.|.|.|.|.|.|.|.|.|.|.|.|,.|.|.|.|.|.|.|.|.|.|.|.|.|.|.|.|,.|.|.|.|.|.|.|.|.|.|.|.|.|.|.|.|,.|.|.|.|.|.|.|.|.|.|.|.|.|.|.|.|,.|.|.|.|.|.|.|.|.|.|.|.|.|.|.|.|,.|.|.|.|.|.|.|.|.|.|.|.|.|.|.|.|,.|.|.|.|.|.|.|.|.|.|.|.|.|.|.|.|,.|.|.|.|.|.|.|.|.|.|.|.|.|.|.|.|,.|.|.|.|.|.|.|.|.|.|.|.|.|.|.|.|,.|.|.|.|.|.|.|.|.|.|.|.|.|.|.|.|
.|.|.|.|.|.|.|.|.|.|.|.|.|.|.|.|,.|.|.|.|.|.|.|.|.|.|.|.|.|.|.|.|,.|.|.|.|.|.|.|.|.|.|.|.|.|.|.|.|,.|.|.|.|.|.|.|.|.|.|.|.|.|.|.|.|,.|.|.|.|.|.|.|.|.|.|.|.|.|.|.|.|,.|.|.|.|.|.|.|.|.|.|.|.|.|.|.|.|,.|.|.|.|.|.|.|.|.|.|.|.|.|.|.|.|,F|.|.|W|.|.|.|2|G|.|.|.|.|.|.|.|,F|.|.|.|.|.|.|.|.|.|.|.|.|.|.|.|,F|.|.|.|.|.|.|.|.|.|.|.|.|.|.|.|,F|W|.|.|.|.|.|3|G|.|.|.|.|.|.|.|,F|W|.|.|.|.|.|.|.|.|.|.|.|.|.|.|,F|W|.|.|.|.|.|3|G|.|.|.|.|.|.|.|,F|W|.|.|.|.|B|.|.|.|.|.|.|.|.|.|,F|W|.|.|.|.|.|.|.|.|.|.|.|.|.|.|,F|W|.|.|.|.|.|.|.|.|.|.|.|.|.|.|,F|W|.|.|.|.|B|.|.|.|.|.|.|.|.|.|,F|W|.|.|.|.|.|1|B|.|.|.|.|.|.|.|,F|W|.|.|.|.|.|1|B|.|.|.|.|.|.|.|,F|W|.|.|.|.|.|.|.|.|.|.|.|.|.|.|,.|.|.|W|.|.|.|.|.|.|.|.|.|.|.|.|,.|.|.|.|.|.|.|.|.|.|.|.|.|.|.|.|,.|.|.|.|.|.|.|.|.|.|.|.|.|.|.|.|,.|.|.|.|.|.|.|.|.|.|.|.|.|.|.|.|,.|.|.|.|.|.|.|.|.|.|.|.|.|.|.|.|,.|.|.|.|.|.|.|.|.|.|.|.|.|.|.|.|,.|.|.|.|.|.|.|.|.|.|.|.|.|.|.|.|,.|.|.|.|.|.|.|.|.|.|.|.|.|.|.|.|
.|.|.|.|.|.|.|.|.|.|.|.|.|.|.|.|,.|.|.|.|.|.|.|.|.|.|.|.|.|.|.|.|,.|.|.|.|.|.|.|.|.|.|.|.|.|.|.|.|,.|.|.|.|.|.|.|.|.|.|.|.|.|.|.|.|,.|.|.|.|.|.|.|.|.|.|.|.|.|.|.|.|,.|.|.|.|.|.|.|.|.|.|.|.|.|.|.|.|,.|.|.|.|.|.|.|.|.|.|.|.|.|.|.|.|,F|.|.|W|.|.|.|.|.|.|.|.|.|.|.|.|,F|.|.|.|.|.|.|.|.|.|.|.|.|.|.|.|,F|.|.|.|.|.|.|.|.|.|.|.|.|.|.|.|,F|.|.|.|.|.|.|.|.|.|.|.|.|.|.|.|,F|.|.|.|.|.|.|.|.|.|.|.|.|.|.|.|,F|.|.|.|.|.|.|.|.|.|.|.|.|.|.|.|,F|.|.|.|.|.|.|.|.|.|.|.|.|.|.|.|,F|.|.|.|.|.|.|.|.|.|.|.|.|.|.|.|,F|.|.|.|.|.|.|.|.|.|.|.|.|.|.|.|,F|.|.|.|.|.|.|.|.|.|.|.|.|.|.|.|,F|.|.|.|.|.|.|.|.|.|.|.|.|.|.|.|,F|.|.|.|.|.|.|.|.|.|.|.|.|.|.|.|,F|.|.|.|.|.|.|.|.|.|.|.|8|.|.|.|,F|W|.|W|S|.|.|.|.|.|.|.|.|.|H|.|,.|.|.|W|.|.|.|.|.|.|.|.|.|.|.|.|,.|.|.|.|.|.|.|.|.|.|.|.|.|.|.|.|,.|.|.|.|.|.|.|.|.|.|.|.|.|.|.|.|,.|.|.|.|.|.|.|.|.|.|.|.|.|.|.|.|,.|.|.|.|.|.|.|.|.|.|.|.|.|.|.|.|,.|.|.|.|.|.|.|.|.|.|.|.|.|.|.|.|,.|.|.|.|.|.|.|.|.|.|.|.|.|.|.|.|
.|.|.|.|.|.|.|.|.|.|.|.|.|.|.|.|,.|.|.|.|.|.|.|.|.|.|.|.|.|.|.|.|,.|.|.|.|.|.|.|.|.|.|.|.|.|.|.|.|,.|.|.|.|.|.|.|.|.|.|.|.|.|.|.|.|,.|.|.|.|.|.|.|.|.|.|.|.|.|.|.|.|,.|.|.|.|.|.|.|.|.|.|.|.|.|.|.|.|,.|.|.|.|.|.|.|.|.|.|.|.|.|.|.|.|,F|.|.|W|.|.|.|.|.|.|.|.|.|.|.|.|,F|.|.|.|.|.|.|.|.|.|.|.|.|.|.|.|,F|.|.|.|.|.|.|.|.|.|.|.|.|.|.|.|,F|.|.|.|.|.|.|3|G|.|.|.|.|.|.|.|,F|.|.|.|.|.|.|.|.|.|.|.|.|.|.|.|,F|.|.|.|.|.|.|3|G|.|.|.|.|.|.|.|,F|.|.|.|.|.|B|.|.|.|.|.|.|.|.|.|,F|.|.|.|.|.|.|.|.|.|.|.|.|.|.|.|,F|.|.|.|.|.|.|.|.|.|.|.|.|.|.|.|,F|.|.|.|.|.|B|.|.|.|.|.|.|.|.|.|,F|.|.|.|.|.|.|1|B|.|.|.|.|.|.|.|,F|.|.|.|.|.|.|1|B|.|.|.|.|.|.|.|,F|.|.|.|.|.|.|.|.|.|.|.|.|.|.|.|,.|W|.|W|.|.|.|.|.|.|.|.|.|.|.|.|,.|.|.|.|.|.|.|.|.|.|.|.|.|.|.|.|,.|.|.|.|.|.|.|.|.|.|.|.|.|.|.|.|,.|.|.|.|.|.|.|.|.|.|.|.|.|.|.|.|,.|.|.|.|.|.|.|.|.|.|.|.|.|.|.|.|,.|.|.|.|.|.|.|.|.|.|.|.|.|.|.|.|,.|.|.|.|.|.|.|.|.|.|.|.|.|.|.|.|,.|.|.|.|.|.|.|.|.|.|.|.|.|.|.|.|
.|.|.|.|.|.|.|.|.|.|.|.|.|.|.|.|,.|.|.|.|.|.|.|.|.|.|.|.|.|.|.|.|,.|.|.|.|.|.|.|.|.|.|.|.|.|.|.|.|,.|.|.|.|.|.|.|.|.|.|.|.|.|.|.|.|,.|.|.|.|.|.|.|.|.|.|.|.|.|.|.|.|,.|.|.|.|.|.|.|.|.|.|.|.|.|.|.|.|,.|.|.|.|.|.|.|.|.|.|.|.|.|.|.|.|,.|W|.|.|.|.|.|.|.|.|.|.|.|.|.|.|,.|W|.|.|.|.|.|.|.|.|.|.|.|.|.|.|,.|W|.|.|.|.|.|.|.|.|.|.|.|.|.|.|,.|W|.|.|.|.|.|.|.|.|.|.|.|.|.|.|,.|W|.|.|.|.|.|.|.|.|.|.|.|.|.|.|,.|W|.|.|.|.|.|.|.|.|.|.|.|.|.|.|,.|W|.|.|.|.|.|.|.|.|.|.|.|.|.|.|,.|W|.|.|.|.|.|.|.|.|.|.|.|.|.|.|,.|W|.|.|.|.|.|.|.|.|.|.|.|.|.|.|,.|W|.|.|.|.|.|.|.|.|.|.|.|.|.|.|,F|.|.|W|.|.|.|.|.|.|.|.|.|.|.|.|,.|W|.|W|.|.|.|.|.|.|.|.|.|.|.|.|,.|W|.|.|.|.|.|.|.|.|.|.|.|.|.|.|,.|.|.|.|.|.|.|.|.|.|.|.|.|.|.|.|,.|.|.|.|.|.|.|.|.|.|.|.|.|.|.|.|,.|.|.|.|.|.|.|.|.|.|.|.|.|.|.|.|,.|.|.|.|.|.|.|.|.|.|.|.|.|.|.|.|,.|.|.|.|.|.|.|.|.|.|.|.|.|.|.|.|,.|.|.|.|.|.|.|.|.|.|.|.|.|.|.|.|,.|.|.|.|.|.|.|.|.|.|.|.|.|.|.|.|,.|.|.|.|.|.|.|.|.|.|.|.|.|.|.|.|
.|.|.|.|.|.|.|.|.|.|.|.|.|.|.|.|,.|.|.|.|.|.|.|.|.|.|.|.|.|.|.|.|,.|.|.|.|.|.|.|.|.|.|.|.|.|.|.|.|,.|.|.|.|.|.|.|.|.|.|.|.|.|.|.|.|,.|.|.|.|.|.|.|.|.|.|.|.|.|.|.|.|,.|.|.|.|.|.|.|.|.|.|.|.|.|.|.|.|,.|.|.|.|.|.|.|.|.|.|.|.|.|.|.|.|,.|.|.|.|.|.|.|.|.|.|.|.|.|.|.|.|,.|.|.|.|.|.|.|.|.|.|.|.|.|.|.|.|,.|.|.|.|.|.|.|.|.|.|.|.|.|.|.|.|,.|.|.|.|.|.|.|.|.|.|.|.|.|.|.|.|,.|.|.|.|.|.|.|.|.|.|.|.|.|.|.|.|,.|.|.|.|.|.|.|.|.|.|.|.|.|.|.|.|,.|.|.|.|.|.|.|.|.|.|.|.|.|.|.|.|,.|.|.|.|.|.|.|.|.|.|.|.|.|.|.|.|,b|.|.|.|.|.|.|.|.|.|.|.|.|.|.|.|,F|.|.|.|.|.|.|.|.|.|.|.|.|.|Q|.|,F|.|.|.|.|.|.|.|.|.|.|.|.|.|.|.|,.|.|.|W|.|.|.|.|.|.|.|.|.|.|.|.|,.|.|.|.|.|.|.|.|.|.|.|.|.|.|.|.|,.|.|.|.|.|.|.|.|.|.|.|.|.|.|.|.|,.|.|.|.|.|.|.|.|.|.|.|.|.|.|.|.|,.|.|.|.|.|.|.|.|.|.|.|.|.|.|.|.|,.|.|.|.|.|.|.|.|.|.|.|.|.|.|.|.|,.|.|.|.|.|.|.|.|.|.|.|.|.|.|.|.|,.|.|.|.|.|.|.|.|.|.|.|.|.|.|.|.|,.|.|.|.|.|.|.|.|.|.|.|.|.|.|.|.|,.|.|.|.|.|.|.|.|.|.|.|.|.|.|.|.|
.|.|.|.|.|.|.|.|.|.|.|.|.|.|.|.|,.|.|.|.|.|.|.|.|.|.|.|.|.|.|.|.|,.|.|.|.|.|.|.|.|.|.|.|.|.|.|.|.|,.|.|.|.|.|.|.|.|.|.|.|.|.|.|.|.|,.|.|.|.|.|.|.|.|.|.|.|.|.|.|.|.|,.|.|.|.|.|.|.|.|.|.|.|.|.|.|.|.|,.|.|.|.|.|.|.|.|.|.|.|.|.|.|.|.|,.|.|.|.|.|.|.|.|.|.|.|.|.|.|.|.|,.|.|.|.|.|.|.|.|.|.|.|.|.|.|.|.|,.|.|.|.|.|.|.|.|.|.|.|.|.|.|.|.|,.|.|.|.|.|.|.|.|.|.|.|.|.|.|.|.|,.|.|.|.|.|.|.|.|.|.|.|.|.|.|.|.|,.|.|.|.|.|.|.|.|.|.|.|.|.|.|.|.|,.|.|.|.|.|.|.|.|.|.|.|.|.|.|.|.|,.|.|.|.|.|.|.|.|.|.|.|.|.|.|.|.|,.|.|.|.|.|.|.|.|.|.|.|.|.|.|.|.|,.|.|.|.|.|.|.|.|.|.|.|.|.|.|.|.|,.|W|.|.|.|.|.|.|.|.|.|.|.|.|.|.|,.|.|.|.|.|.|.|.|.|.|.|.|.|.|.|.|,.|.|.|.|.|.|.|.|.|.|.|.|.|.|.|.|,.|.|.|.|.|.|.|.|.|.|.|.|.|.|.|.|,.|.|.|.|.|.|.|.|.|.|.|.|.|.|.|.|,.|.|.|.|.|.|.|.|.|.|.|.|.|.|.|.|,.|.|.|.|.|.|.|.|.|.|.|.|.|.|.|.|,.|.|.|.|.|.|.|.|.|.|.|.|.|.|.|.|,.|.|.|.|.|.|.|.|.|.|.|.|.|.|.|.|,.|.|.|.|.|.|.|.|.|.|.|.|.|.|.|.|,.|.|.|.|.|.|.|.|.|.|.|.|.|.|.|.|
.|.|.|.|.|.|.|.|.|.|.|.|.|.|.|.|,.|.|.|.|.|.|.|.|.|.|.|.|.|.|.|.|,.|.|.|.|.|.|.|.|.|.|.|.|.|.|.|.|,.|.|.|.|.|.|.|.|.|.|.|.|.|.|.|.|,.|.|.|.|.|.|.|.|.|.|.|.|.|.|.|.|,.|.|.|.|.|.|.|.|.|.|.|.|.|.|.|.|,.|.|.|.|.|.|.|.|.|.|.|.|.|.|.|.|,.|.|.|.|.|.|.|.|.|.|.|.|.|.|.|.|,.|.|.|.|.|.|.|.|.|.|.|.|.|.|.|.|,.|.|.|.|.|.|.|.|.|.|.|.|.|.|.|.|,.|.|.|.|.|.|.|.|.|.|.|.|.|.|.|.|,.|.|.|.|.|.|.|.|.|.|.|.|.|.|.|.|,.|.|.|.|.|.|.|.|.|.|.|.|.|.|.|.|,.|.|.|.|.|.|.|.|.|.|.|.|.|.|.|.|,.|.|.|.|.|.|.|.|.|.|.|.|.|.|.|.|,.|.|.|.|.|.|.|.|.|.|.|.|.|.|.|.|,.|.|.|.|.|.|.|.|.|.|.|.|.|.|.|.|,.|.|.|.|.|.|.|.|.|.|.|.|.|.|.|.|,.|.|.|.|.|.|.|.|.|.|.|.|.|.|.|.|,.|.|.|.|.|.|.|.|.|.|.|.|.|.|.|.|,.|.|.|.|.|.|.|.|.|.|.|.|.|.|.|.|,.|.|.|.|.|.|.|.|.|.|.|.|.|.|.|.|,.|.|.|.|.|.|.|.|.|.|.|.|.|.|.|.|,.|.|.|.|.|.|.|.|.|.|.|.|.|.|.|.|,.|.|.|.|.|.|.|.|.|.|.|.|.|.|.|.|,.|.|.|.|.|.|.|.|.|.|.|.|.|.|.|.|,.|.|.|.|.|.|.|.|.|.|.|.|.|.|.|.|,.|.|.|.|.|.|.|.|.|.|.|.|.|.|.|.|
.|.|.|.|.|.|.|.|.|.|.|.|.|.|.|.|,.|.|.|.|.|.|.|.|.|.|.|.|.|.|.|.|,.|.|.|.|.|.|.|.|.|.|.|.|.|.|.|.|,.|.|.|.|.|.|.|.|.|.|.|.|.|.|.|.|,.|.|.|.|.|.|.|.|.|.|.|.|.|.|.|.|,.|.|.|.|.|.|.|.|.|.|.|.|.|.|.|.|,.|.|.|.|.|.|.|.|.|.|.|.|.|.|.|.|,.|.|.|.|.|.|.|.|.|.|.|.|.|.|.|.|,.|.|.|.|.|.|.|.|.|.|.|.|.|.|.|.|,.|.|.|.|.|.|.|.|.|.|.|.|.|.|.|.|,.|.|.|.|.|.|.|.|.|.|.|.|.|.|.|.|,.|.|.|.|.|.|.|.|.|.|.|.|.|.|.|.|,.|.|.|.|.|.|.|.|.|.|.|.|.|.|.|.|,.|.|.|.|.|.|.|.|.|.|.|.|.|.|.|.|,.|.|.|.|.|.|.|.|.|.|.|.|.|.|.|.|,.|.|.|.|.|.|.|.|.|.|.|.|.|.|.|.|,.|.|.|.|.|.|.|.|.|.|.|.|.|.|.|.|,.|.|.|.|.|.|.|.|.|.|.|.|.|.|.|.|,.|.|.|.|.|.|.|.|.|.|.|.|.|.|.|.|,.|.|.|.|.|.|.|.|.|.|.|.|.|.|.|.|,.|.|.|.|.|.|.|.|.|.|.|.|.|.|.|.|,.|.|.|.|.|.|.|.|.|.|.|.|.|.|.|.|,.|.|.|.|.|.|.|.|.|.|.|.|.|.|.|.|,.|.|.|.|.|.|.|.|.|.|.|.|.|.|.|.|,.|.|.|.|.|.|.|.|.|.|.|.|.|.|.|.|,.|.|.|.|.|.|.|.|.|.|.|.|.|.|.|.|,.|.|.|.|.|.|.|.|.|.|.|.|.|.|.|.|,.|.|.|.|.|.|.|.|.|.|.|.|.|.|.|.|
.|.|.|.|.|.|.|.|.|.|.|.|.|.|.|.|,.|.|.|.|.|.|.|.|.|.|.|.|.|.|.|.|,.|.|.|.|.|.|.|.|.|.|.|.|.|.|.|.|,.|.|.|.|.|.|.|.|.|.|.|.|.|.|.|.|,.|.|.|.|.|.|.|.|.|.|.|.|.|.|.|.|,.|.|.|.|.|.|.|.|.|.|.|.|.|.|.|.|,.|.|.|.|.|.|.|.|.|.|.|.|.|.|.|.|,.|.|.|.|.|.|.|.|.|.|.|.|.|.|.|.|,.|.|.|.|.|.|.|.|.|.|.|.|.|.|.|.|,.|.|.|.|.|.|.|.|.|.|.|.|.|.|.|.|,.|.|.|.|.|.|.|.|.|.|.|.|.|.|.|.|,.|.|.|.|.|.|.|.|.|.|.|.|.|.|.|.|,.|.|.|.|.|.|.|.|.|.|.|.|.|.|.|.|,.|.|.|.|.|.|.|.|.|.|.|.|.|.|.|.|,.|.|.|.|.|.|.|.|.|.|.|.|.|.|.|.|,.|.|.|.|.|.|.|.|.|.|.|.|.|.|.|.|,.|.|.|.|.|.|.|.|.|.|.|.|.|.|.|.|,.|.|.|.|.|.|.|.|.|.|.|.|.|.|.|.|,.|.|.|.|.|.|.|.|.|.|.|.|.|.|.|.|,.|.|.|.|.|.|.|.|.|.|.|.|.|.|.|.|,.|.|.|.|.|.|.|.|.|.|.|.|.|.|.|.|,.|.|.|.|.|.|.|.|.|.|.|.|.|.|.|.|,.|.|.|.|.|.|.|.|.|.|.|.|.|.|.|.|,.|.|.|.|.|.|.|.|.|.|.|.|.|.|.|.|,.|.|.|.|.|.|.|.|.|.|.|.|.|.|.|.|,.|.|.|.|.|.|.|.|.|.|.|.|.|.|.|.|,.|.|.|.|.|.|.|.|.|.|.|.|.|.|.|.|,.|.|.|.|.|.|.|.|.|.|.|.|.|.|.|.|
.|.|.|.|.|.|.|.|.|.|.|.|.|.|.|.|,.|.|.|.|.|.|.|.|.|.|.|.|.|.|.|.|,.|.|.|.|.|.|.|.|.|.|.|.|.|.|.|.|,.|.|.|.|.|.|.|.|.|.|.|.|.|.|.|.|,.|.|.|.|.|.|.|.|.|.|.|.|.|.|.|.|,.|.|.|.|.|.|.|.|.|.|.|.|.|.|.|.|,.|.|.|.|.|.|.|.|.|.|.|.|.|.|.|.|,.|.|.|.|.|.|.|.|.|.|.|.|.|.|.|.|,.|.|.|.|.|.|.|.|.|.|.|.|.|.|.|.|,.|.|.|.|.|.|.|.|.|.|.|.|.|.|.|.|,.|.|.|.|.|.|.|.|.|.|.|.|.|.|.|.|,.|.|.|.|.|.|.|.|.|.|.|.|.|.|.|.|,.|.|.|.|.|.|.|.|.|.|.|.|.|.|.|.|,.|.|.|.|.|.|.|.|.|.|.|.|.|.|.|.|,.|.|.|.|.|.|.|.|.|.|.|.|.|.|.|.|,.|.|.|.|.|.|.|.|.|.|.|.|.|.|.|.|,.|.|.|.|.|.|.|.|.|.|.|.|.|.|.|.|,.|.|.|.|.|.|.|.|.|.|.|.|.|.|.|.|,.|.|.|.|.|.|.|.|.|.|.|.|.|.|.|.|,.|.|.|.|.|.|.|.|.|.|.|.|.|.|.|.|,.|.|.|.|.|.|.|.|.|.|.|.|.|.|.|.|,.|.|.|.|.|.|.|.|.|.|.|.|.|.|.|.|,.|.|.|.|.|.|.|.|.|.|.|.|.|.|.|.|,.|.|.|.|.|.|.|.|.|.|.|.|.|.|.|.|,.|.|.|.|.|.|.|.|.|.|.|.|.|.|.|.|,.|.|.|.|.|.|.|.|.|.|.|.|.|.|.|.|,.|.|.|.|.|.|.|.|.|.|.|.|.|.|.|.|,.|.|.|.|.|.|.|.|.|.|.|.|.|.|.|.|
.|.|.|.|.|.|.|.|.|.|.|.|.|.|.|.|,.|.|.|.|.|.|.|.|.|.|.|.|.|.|.|.|,.|.|.|.|.|.|.|.|.|.|.|.|.|.|.|.|,.|.|.|.|.|.|.|.|.|.|.|.|.|.|.|.|,.|.|.|.|.|.|.|.|.|.|.|.|.|.|.|.|,.|.|.|.|.|.|.|.|.|.|.|.|.|.|.|.|,.|.|.|.|.|.|.|.|.|.|.|.|.|.|.|.|,.|.|.|.|.|.|.|.|.|.|.|.|.|.|.|.|,.|.|.|.|.|.|.|.|.|.|.|.|.|.|.|.|,.|.|.|.|.|.|.|.|.|.|.|.|.|.|.|.|,.|.|.|.|.|.|.|.|.|.|.|.|.|.|.|.|,.|.|.|.|.|.|.|.|.|.|.|.|.|.|.|.|,.|.|.|.|.|.|.|.|.|.|.|.|.|.|.|.|,.|.|.|.|.|.|.|.|.|.|.|.|.|.|.|.|,.|.|.|.|.|.|.|.|.|.|.|.|.|.|.|.|,.|.|.|.|.|.|.|.|.|.|.|.|.|.|.|.|,.|.|.|.|.|.|.|.|.|.|.|.|.|.|.|.|,.|.|.|.|.|.|.|.|.|.|.|.|.|.|.|.|,.|.|.|.|.|.|.|.|.|.|.|.|.|.|.|.|,.|.|.|.|.|.|.|.|.|.|.|.|.|.|.|.|,.|.|.|.|.|.|.|.|.|.|.|.|.|.|.|.|,.|.|.|.|.|.|.|.|.|.|.|.|.|.|.|.|,.|.|.|.|.|.|.|.|.|.|.|.|.|.|.|.|,.|.|.|.|.|.|.|.|.|.|.|.|.|.|.|.|,.|.|.|.|.|.|.|.|.|.|.|.|.|.|.|.|,.|.|.|.|.|.|.|.|.|.|.|.|.|.|.|.|,.|.|.|.|.|.|.|.|.|.|.|.|.|.|.|.|,.|.|.|.|.|.|.|.|.|.|.|.|.|.|.|.|
.|.|.|.|.|.|.|.|.|.|.|.|.|.|.|.|,.|.|.|.|.|.|.|.|.|.|.|.|.|.|.|.|,.|.|.|.|.|.|.|.|.|.|.|.|.|.|.|.|,.|.|.|.|.|.|.|.|.|.|.|.|.|.|.|.|,.|.|.|.|.|.|.|.|.|.|.|.|.|.|.|.|,.|.|.|.|.|.|.|.|.|.|.|.|.|.|.|.|,.|.|.|.|.|.|.|.|.|.|.|.|.|.|.|.|,.|.|.|.|.|.|.|.|.|.|.|.|.|.|.|.|,.|.|.|.|.|.|.|.|.|.|.|.|.|.|.|.|,.|.|.|.|.|.|.|.|.|.|.|.|.|.|.|.|,.|.|.|.|.|.|.|.|.|.|.|.|.|.|.|.|,.|.|.|.|.|.|.|.|.|.|.|.|.|.|.|.|,.|.|.|.|.|.|.|.|.|.|.|.|.|.|.|.|,.|.|.|.|.|.|.|.|.|.|.|.|.|.|.|.|,.|.|.|.|.|.|.|.|.|.|.|.|.|.|.|.|,.|.|.|.|.|.|.|.|.|.|.|.|.|.|.|.|,.|.|.|.|.|.|.|.|.|.|.|.|.|.|.|.|,.|.|.|.|.|.|.|.|.|.|.|.|.|.|.|.|,.|.|.|.|.|.|.|.|.|.|.|.|.|.|.|.|,.|.|.|.|.|.|.|.|.|.|.|.|.|.|.|.|,.|.|.|.|.|.|.|.|.|.|.|.|.|.|.|.|,.|.|.|.|.|.|.|.|.|.|.|.|.|.|.|.|,.|.|.|.|.|.|.|.|.|.|.|.|.|.|.|.|,.|.|.|.|.|.|.|.|.|.|.|.|.|.|.|.|,.|.|.|.|.|.|.|.|.|.|.|.|.|.|.|.|,.|.|.|.|.|.|.|.|.|.|.|.|.|.|.|.|,.|.|.|.|.|.|.|.|.|.|.|.|.|.|.|.|,.|.|.|.|.|.|.|.|.|.|.|.|.|.|.|.|
.|.|.|.|.|.|.|.|.|.|.|.|.|.|.|.|,.|.|.|.|.|.|.|.|.|.|.|.|.|.|.|.|,.|.|.|.|.|.|.|.|.|.|.|.|.|.|.|.|,.|.|.|.|.|.|.|.|.|.|.|.|.|.|.|.|,.|.|.|.|.|.|.|.|.|.|.|.|.|.|.|.|,.|.|.|.|.|.|.|.|.|.|.|.|.|.|.|.|,.|.|.|.|.|.|.|.|.|.|.|.|.|.|.|.|,.|.|.|.|.|.|.|.|.|.|.|.|.|.|.|.|,.|.|.|.|.|.|.|.|.|.|.|.|.|.|.|.|,.|.|.|.|.|.|.|.|.|.|.|.|.|.|.|.|,.|.|.|.|.|.|.|.|.|.|.|.|.|.|.|.|,.|.|.|.|.|.|.|.|.|.|.|.|.|.|.|.|,.|.|.|.|.|.|.|.|.|.|.|.|.|.|.|.|,.|.|.|.|.|.|.|.|.|.|.|.|.|.|.|.|,.|.|.|.|.|.|.|.|.|.|.|.|.|.|.|.|,.|.|.|.|.|.|.|.|.|.|.|.|.|.|.|.|,.|.|.|.|.|.|.|.|.|.|.|.|.|.|.|.|,.|.|.|.|.|.|.|.|.|.|.|.|.|.|.|.|,.|.|.|.|.|.|.|.|.|.|.|.|.|.|.|.|,.|.|.|.|.|.|.|.|.|.|.|.|.|.|.|.|,.|.|.|.|.|.|.|.|.|.|.|.|.|.|.|.|,.|.|.|.|.|.|.|.|.|.|.|.|.|.|.|.|,.|.|.|.|.|.|.|.|.|.|.|.|.|.|.|.|,.|.|.|.|.|.|.|.|.|.|.|.|.|.|.|.|,.|.|.|.|.|.|.|.|.|.|.|.|.|.|.|.|,.|.|.|.|.|.|.|.|.|.|.|.|.|.|.|.|,.|.|.|.|.|.|.|.|.|.|.|.|.|.|.|.|,.|.|.|.|.|.|.|.|.|.|.|.|.|.|.|.|
.|.|.|.|.|.|.|.|.|.|.|.|.|.|.|.|,.|.|.|.|.|.|.|.|.|.|.|.|.|.|.|.|,.|.|.|.|.|.|.|.|.|.|.|.|.|.|.|.|,.|.|.|.|.|.|.|.|.|.|.|.|.|.|.|.|,.|.|.|.|.|.|.|.|.|.|.|.|.|.|.|.|,.|.|.|.|.|.|.|.|.|.|.|.|.|.|.|.|,.|.|.|.|.|.|.|.|.|.|.|.|.|.|.|.|,.|.|.|.|.|.|.|.|.|.|.|.|.|.|.|.|,.|.|.|.|.|.|.|.|.|.|.|.|.|.|.|.|,.|.|.|.|.|.|.|.|.|.|.|.|.|.|.|.|,.|.|.|.|.|.|.|.|.|.|.|.|.|.|.|.|,.|.|.|.|.|.|.|.|.|.|.|.|.|.|.|.|,.|.|.|.|.|.|.|.|.|.|.|.|.|.|.|.|,.|.|.|.|.|.|.|.|.|.|.|.|.|.|.|.|,.|.|.|.|.|.|.|.|.|.|.|.|.|.|.|.|,.|.|.|.|.|.|.|.|.|.|.|.|.|.|.|.|,.|.|.|.|.|.|.|.|.|.|.|.|.|.|.|.|,.|.|.|.|.|.|.|.|.|.|.|.|.|.|.|.|,.|.|.|.|.|.|.|.|.|.|.|.|.|.|.|.|,.|.|.|.|.|.|.|.|.|.|.|.|.|.|.|.|,.|.|.|.|.|.|.|.|.|.|.|.|.|.|.|.|,.|.|.|.|.|.|.|.|.|.|.|.|.|.|.|.|,.|.|.|.|.|.|.|.|.|.|.|.|.|.|.|.|,.|.|.|.|.|.|.|.|.|.|.|.|.|.|.|.|,.|.|.|.|.|.|.|.|.|.|.|.|.|.|.|.|,.|.|.|.|.|.|.|.|.|.|.|.|.|.|.|.|,.|.|.|.|.|.|.|.|.|.|.|.|.|.|.|.|,.|.|.|.|.|.|.|.|.|.|.|.|.|.|.|.|
