.|.|.|.|.|.|.|.|.|.|.|.|.|.|.|.|,.|.|.|.|.|.|.|.|.|.|.|.|.|.|.|.|,.|.|.|.|.|.|.|.|.|.|.|.|.|.|.|.|,.|.|.|.|.|.|.|.|.|.|.|.|.|.|.|.|,.|.|.|.|.|.|.|.|.|.|.|.|.|.|.|.|,.|.|.|.|.|.|.|.|.|.|.|.|.|.|.|.|,.|.|.|.|.|.|.|.|.|.|.|.|.|.|.|.|,.|.|.|.|.|.|.|.|.|.|.|.|.|.|.|.|,.|.|.|.|.|.|.|.|.|.|.|.|.|.|.|.|,.|.|.|.|.|.|.|.|.|.|.|.|.|.|.|.|,.|.|.|.|.|.|.|.|.|.|.|.|.|.|.|.|,.|.|.|.|.|.|.|.|.|.|.|.|.|.|.|.|,.|.|.|.|.|.|.|.|.|.|.|.|.|.|.|.|,.|.|.|.|.|.|.|.|.|.|.|.|.|.|.|.|,.|.|.|.|.|.|.|.|.|.|.|.|.|.|.|.|,.|.|.|.|.|.|.|.|.|.|.|.|.|.|.|.|,.|.|.|.|.|.|.|.|.|.|.|.|.|.|.|.|,.|.|.|.|.|.|.|.|.|.|.|.|.|.|.|.|,.|.|.|.|.|.|.|.|.|.|.|.|.|.|.|.|,.|.|.|.|.|.|.|.|.|.|.|.|.|.|.|.|,.|.|.|.|.|.|.|.|.|.|.|.|.|.|.|.|,.|.|.|.|.|.|.|.|.|.|.|.|.|.|.|.|,.|.|.|.|.|.|.|.|.|.|.|.|.|.|.|.|,.|.|.|.|.|.|.|.|.|.|.|.|.|.|.|.|,.|.|.|.|.|.|.|.|.|.|.|.|.|.|.|.|,.|.|.|.|.|.|.|.|.|.|.|.|.|.|.|.|,.|.|.|.|.|.|.|.|.|.|.|.|.|.|.|.|,.|.|.|.|.|.|.|.|.|.|.|.|.|.|.|.|
.|.|.|.|.|.|.|.|.|.|.|.|.|.|.|.|,.|.|.|.|.|.|.|.|.|.|.|.|.|.|.|.|,.|.|.|.|.|.|.|.|.|.|.|.|.|.|.|.|,.|.|.|.|.|.|.|.|.|.|.|.|.|.|.|.|,.|.|.|.|.|.|.|.|.|.|.|.|.|.|.|.|,.|.|.|.|.|.|.|.|.|.|.|.|.|.|.|.|,.|.|.|.|.|.|.|.|.|.|.|.|.|.|.|.|,.|.|.|.|.|.|.|.|.|.|.|.|.|.|.|.|,.|.|.|.|.|.|.|.|.|.|.|.|.|.|.|.|,.|.|.|.|.|.|.|.|.|.|.|.|.|.|.|.|,.|.|.|.|.|.|.|.|.|.|.|.|.|.|.|.|,.|.|.|.|.|.|.|.|.|.|.|.|.|.|.|.|,.|.|.|.|.|.|.|.|.|.|.|.|.|.|.|.|,.|.|.|.|.|.|.|.|.|.|.|.|.|.|.|.|,.|.|.|.|.|.|.|.|.|.|.|.|.|.|.|.|,.|.|.|.|.|.|.|.|.|.|.|.|.|.|.|.|,.|.|.|.|.|.|.|.|.|.|.|.|.|.|.|.|,.|.|.|.|.|.|.|.|.|.|.|.|.|.|.|.|,.|.|.|.|.|.|.|.|.|.|.|.|.|.|.|.|,.|.|.|.|.|.|.|.|.|.|.|.|.|.|.|.|,F|W|.|W|.|.|.|3|C|.|.|.|.|.|.|.|,F|W|.|.|.|.|.|.|.|.|.|.|2|.|.|.|,d|W|.|.|.|.|.|.|.|.|.|.|.|1|P|.|,.|.|.|W|.|.|.|.|.|.|.|.|.|.|.|.|,.|.|.|.|.|.|.|.|.|.|.|.|.|.|.|.|,.|.|.|.|.|.|.|.|.|.|.|.|.|.|.|.|,.|.|.|.|.|.|.|.|.|.|.|.|.|.|.|.|,.|.|.|.|.|.|.|.|.|.|.|.|.|.|.|.|
.|.|.|.|.|.|.|.|.|.|.|.|.|.|.|.|,.|.|.|.|.|.|.|.|.|.|.|.|.|.|.|.|,.|.|.|.|.|.|.|.|.|.|.|.|.|.|.|.|,.|.|.|.|.|.|.|.|.|.|.|.|.|.|.|.|,.|.|.|.|.|.|.|.|.|.|.|.|.|.|.|.|,.|.|.|.|.|.|.|.|.|.|.|.|.|.|.|.|,.|.|.|.|.|.|.|.|.|.|.|.|.|.|.|.|,.|.|.|.|.|.|.|.|.|.|.|.|.|.|.|.|,.|.|.|.|.|.|.|.|.|.|.|.|.|.|.|.|,.|.|.|.|.|.|.|.|.|.|.|.|.|.|.|.|,.|.|.|.|.|.|.|.|.|.|.|.|.|.|.|.|,.|.|.|.|.|.|.|.|.|.|.|.|.|.|.|.|,.|.|.|.|.|.|.|.|.|.|.|.|.|.|.|.|,.|.|.|.|.|.|.|.|.|.|.|.|.|.|.|.|,.|.|.|.|.|.|.|.|.|.|.|.|.|.|.|.|,.|.|.|.|.|.|.|.|.|.|.|.|.|.|.|.|,.|.|.|.|.|.|.|.|.|.|.|.|.|.|.|.|,.|.|.|.|.|.|.|.|.|.|.|.|.|.|.|.|,.|.|.|.|.|.|.|.|.|.|.|.|.|.|.|.|,.|.|.|.|.|.|.|.|.|.|.|.|.|.|.|.|,F|.|.|W|.|.|.|2|C|.|.|.|.|.|.|.|,.|W|.|W|.|.|.|.|.|.|.|.|.|.|.|.|,.|W|.|.|.|.|.|.|.|.|.|.|.|.|.|.|,.|.|.|.|.|.|.|.|.|.|.|.|.|.|.|.|,.|.|.|.|.|.|.|.|.|.|.|.|.|.|.|.|,.|.|.|.|.|.|.|.|.|.|.|.|.|.|.|.|,.|.|.|.|.|.|.|.|.|.|.|.|.|.|.|.|,.|.|.|.|.|.|.|.|.|.|.|.|.|.|.|.|
.|.|.|.|.|.|.|.|.|.|.|.|.|.|.|.|,.|.|.|.|.|.|.|.|.|.|.|.|.|.|.|.|,.|.|.|.|.|.|.|.|.|.|.|.|.|.|.|.|,.|.|.|.|.|.|.|.|.|.|.|.|.|.|.|.|,.|.|.|.|.|.|.|.|.|.|.|.|.|.|.|.|,.|.|.|.|.|.|.|.|.|.|.|.|.|.|.|.|,.|.|.|.|.|.|.|.|.|.|.|.|.|.|.|.|,.|.|.|.|.|.|.|.|.|.|.|.|.|.|.|.|,.|.|.|.|.|.|.|.|.|.|.|.|.|.|.|.|,.|.|.|.|.|.|.|.|.|.|.|.|.|.|.|.|,F|W|.|W|.|.|.|.|.|.|.|.|.|.|.|.|,F|W|.|W|.|.|.|0|H|.|.|.|.|.|.|.|,F|W|.|.|.|.|.|.|.|.|H|.|.|.|.|.|,.|.|.|W|.|.|.|.|.|.|.|.|.|.|.|.|,.|.|.|.|.|.|.|.|.|.|.|.|.|.|.|.|,.|.|.|.|.|.|.|.|.|.|.|.|.|.|.|.|,.|.|.|.|.|.|.|.|.|.|.|.|.|.|.|.|,.|.|.|.|.|.|.|.|.|.|.|.|.|.|.|.|,F|W|.|W|.|.|D|.|.|.|.|.|.|.|.|.|,F|W|.|.|.|.|L|0|.|.|.|.|.|.|.|.|,F|.|.|W|.|.|.|.|.|.|.|.|.|.|.|.|,F|W|.|W|.|.|L|0|.|.|.|.|.|.|.|.|,F|W|.|.|.|.|D|.|.|.|.|.|.|.|.|.|,.|.|.|W|.|.|.|.|.|.|.|.|.|.|.|.|,.|.|.|.|.|.|.|.|.|.|.|.|.|.|.|.|,.|.|.|.|.|.|.|.|.|.|.|.|.|.|.|.|,.|.|.|.|.|.|.|.|.|.|.|.|.|.|.|.|,.|.|.|.|.|.|.|.|.|.|.|.|.|.|.|.|
.|.|.|.|.|.|.|.|.|.|.|.|.|.|.|.|,.|.|.|.|.|.|.|.|.|.|.|.|.|.|.|.|,.|.|.|.|.|.|.|.|.|.|.|.|.|.|.|.|,.|.|.|.|.|.|.|.|.|.|.|.|.|.|.|.|,.|.|.|.|.|.|.|.|.|.|.|.|.|.|.|.|,.|.|.|.|.|.|.|.|.|.|.|.|.|.|.|.|,.|.|.|.|.|.|.|.|.|.|.|.|.|.|.|.|,.|.|.|.|.|.|.|.|.|.|.|.|.|.|.|.|,.|.|.|.|.|.|.|.|.|.|.|.|.|.|.|.|,.|.|.|.|.|.|.|.|.|.|.|.|.|.|.|.|,F|.|.|W|.|.|.|.|.|.|.|.|.|.|.|.|,F|.|.|W|D|.|.|.|.|.|.|.|.|.|.|.|,F|.|.|.|.|.|.|.|.|.|.|.|.|.|.|.|,.|.|.|W|.|.|.|.|.|.|.|.|.|.|.|.|,.|.|.|.|.|.|.|.|.|.|.|.|.|.|.|.|,.|.|.|.|.|.|.|.|.|.|.|.|.|.|.|.|,.|.|.|.|.|.|.|.|.|.|.|.|.|.|.|.|,.|.|.|.|.|.|.|.|.|.|.|.|.|.|.|.|,F|.|.|W|.|.|.|.|.|.|C|.|.|.|.|.|,F|.|.|.|.|.|.|.|.|.|.|.|.|.|.|.|,F|.|.|W|D|.|.|.|.|.|.|.|.|.|.|.|,F|.|.|W|D|.|.|.|.|.|.|.|.|.|.|.|,F|.|.|.|.|.|.|.|.|.|F|.|.|.|.|.|,.|.|.|W|.|.|.|.|.|.|.|.|.|.|.|.|,.|.|.|.|.|.|.|.|.|.|.|.|.|.|.|.|,.|.|.|.|.|.|.|.|.|.|.|.|.|.|.|.|,.|.|.|.|.|.|.|.|.|.|.|.|.|.|.|.|,.|.|.|.|.|.|.|.|.|.|.|.|.|.|.|.|
.|.|.|.|.|.|.|.|.|.|.|.|.|.|.|.|,.|.|.|.|.|.|.|.|.|.|.|.|.|.|.|.|,.|.|.|.|.|.|.|.|.|.|.|.|.|.|.|.|,.|.|.|.|.|.|.|.|.|.|.|.|.|.|.|.|,.|.|.|.|.|.|.|.|.|.|.|.|.|.|.|.|,.|.|.|.|.|.|.|.|.|.|.|.|.|.|.|.|,.|.|.|.|.|.|.|.|.|.|.|.|.|.|.|.|,.|.|.|.|.|.|.|.|.|.|.|.|.|.|.|.|,.|.|.|.|.|.|.|.|.|.|.|.|.|.|.|.|,.|.|.|.|.|.|.|.|.|.|.|.|.|.|.|.|,F|.|.|W|.|.|.|.|.|.|.|.|.|.|.|.|,F|.|.|W|.|.|.|2|H|.|.|.|.|.|.|.|,F|.|.|.|.|.|.|.|.|.|.|.|.|.|.|.|,.|.|.|W|.|.|.|.|.|.|.|.|.|.|.|.|,.|.|.|.|.|.|.|.|.|.|.|.|.|.|.|.|,.|.|.|.|.|.|.|.|.|.|.|.|.|.|.|.|,.|.|.|.|.|.|.|.|.|.|.|.|.|.|.|.|,.|.|.|.|.|.|.|.|.|.|.|.|.|.|.|.|,.|W|.|.|.|.|.|.|.|.|.|.|.|.|.|.|,.|W|.|.|.|.|.|.|.|.|.|.|.|.|.|.|,F|.|.|W|.|.|.|.|.|.|.|.|.|.|.|.|,.|W|.|W|.|.|.|.|.|.|.|.|.|.|.|.|,.|W|.|.|.|.|.|.|.|.|.|.|.|.|.|.|,.|.|.|.|.|.|.|.|.|.|.|.|.|.|.|.|,.|.|.|.|.|.|.|.|.|.|.|.|.|.|.|.|,.|.|.|.|.|.|.|.|.|.|.|.|.|.|.|.|,.|.|.|.|.|.|.|.|.|.|.|.|.|.|.|.|,.|.|.|.|.|.|.|.|.|.|.|.|.|.|.|.|
.|.|.|.|.|.|.|.|.|.|.|.|.|.|.|.|,.|.|.|.|.|.|.|.|.|.|.|.|.|.|.|.|,.|.|.|.|.|.|.|.|.|.|.|.|.|.|.|.|,.|.|.|.|.|.|.|.|.|.|.|.|.|.|.|.|,.|.|.|.|.|.|.|.|.|.|.|.|.|.|.|.|,.|.|.|.|.|.|.|.|.|.|.|.|.|.|.|.|,.|.|.|.|.|.|.|.|.|.|.|.|.|.|.|.|,.|.|.|.|.|.|.|.|.|.|.|.|.|.|.|.|,.|.|.|.|.|.|.|.|.|.|.|.|.|.|.|.|,.|.|.|.|.|.|.|.|.|.|.|.|.|.|.|.|,F|.|.|W|.|.|.|.|.|.|.|.|.|.|.|.|,F|.|.|W|.|.|.|.|.|.|.|.|.|.|.|.|,F|.|.|.|.|.|.|.|.|.|E|.|.|.|.|.|,.|.|.|W|.|.|.|.|.|.|.|.|.|.|.|.|,.|.|.|.|.|.|.|.|.|.|.|.|.|.|.|.|,.|.|.|.|.|.|.|.|.|.|.|.|.|.|.|.|,.|.|.|.|.|.|.|.|.|.|.|.|.|.|.|.|,.|.|.|.|.|.|.|.|.|.|.|.|.|.|.|.|,F|W|.|W|.|.|D|.|.|.|A|.|.|.|.|.|,F|W|.|.|.|.|L|0|.|.|.|.|.|.|.|.|,F|.|.|W|D|.|.|.|.|.|.|.|.|.|.|.|,F|W|.|W|D|.|.|.|.|.|.|.|.|.|.|.|,F|W|.|.|.|.|D|1|G|.|.|.|.|.|.|.|,.|.|.|W|.|.|.|.|.|.|.|.|.|.|.|.|,.|.|.|.|.|.|.|.|.|.|.|.|.|.|.|.|,.|.|.|.|.|.|.|.|.|.|.|.|.|.|.|.|,.|.|.|.|.|.|.|.|.|.|.|.|.|.|.|.|,.|.|.|.|.|.|.|.|.|.|.|.|.|.|.|.|
.|.|.|.|.|.|.|.|.|.|.|.|.|.|.|.|,.|.|.|.|.|.|.|.|.|.|.|.|.|.|.|.|,.|.|.|.|.|.|.|.|.|.|.|.|.|.|.|.|,.|.|.|.|.|.|.|.|.|.|.|.|.|.|.|.|,.|.|.|.|.|.|.|.|.|.|.|.|.|.|.|.|,.|.|.|.|.|.|.|.|.|.|.|.|.|.|.|.|,.|.|.|.|.|.|.|.|.|.|.|.|.|.|.|.|,.|.|.|.|.|.|.|.|.|.|.|.|.|.|.|.|,.|.|.|.|.|.|.|.|.|.|.|.|.|.|.|.|,.|.|.|.|.|.|.|.|.|.|.|.|.|.|.|.|,F|.|.|W|.|.|.|.|.|.|.|.|.|.|.|.|,.|W|.|W|.|.|.|.|.|.|.|.|.|.|.|.|,.|W|.|.|.|.|.|.|.|.|.|.|.|.|.|.|,.|.|.|.|.|.|.|.|.|.|.|.|.|.|.|.|,.|.|.|.|.|.|.|.|.|.|.|.|.|.|.|.|,.|.|.|.|.|.|.|.|.|.|.|.|.|.|.|.|,.|.|.|.|.|.|.|.|.|.|.|.|.|.|.|.|,.|.|.|.|.|.|.|.|.|.|.|.|.|.|.|.|,F|.|.|W|.|.|.|.|.|.|.|.|.|.|.|.|,F|.|.|.|.|.|.|.|.|.|.|.|.|.|.|.|,F|.|.|W|.|.|.|.|.|.|.|.|.|.|.|.|,F|.|.|W|.|.|.|.|.|.|.|.|.|.|.|.|,F|.|.|.|.|.|.|.|.|.|.|.|.|.|.|.|,.|.|.|W|.|.|.|.|.|.|.|.|.|.|.|.|,.|.|.|.|.|.|.|.|.|.|.|.|.|.|.|.|,.|.|.|.|.|.|.|.|.|.|.|.|.|.|.|.|,.|.|.|.|.|.|.|.|.|.|.|.|.|.|.|.|,.|.|.|.|.|.|.|.|.|.|.|.|.|.|.|.|
.|.|.|.|.|.|.|.|.|.|.|.|.|.|.|.|,.|.|.|.|.|.|.|.|.|.|.|.|.|.|.|.|,.|.|.|.|.|.|.|.|.|.|.|.|.|.|.|.|,.|.|.|.|.|.|.|.|.|.|.|.|.|.|.|.|,.|.|.|.|.|.|.|.|.|.|.|.|.|.|.|.|,.|.|.|.|.|.|.|.|.|.|.|.|.|.|.|.|,.|.|.|.|.|.|.|.|.|.|.|.|.|.|.|.|,.|.|.|.|.|.|.|.|.|.|.|.|.|.|.|.|,.|.|.|.|.|.|.|.|.|.|.|.|.|.|.|.|,.|.|.|.|.|.|.|.|.|.|.|.|.|.|.|.|,F|.|.|W|.|.|.|.|.|.|.|.|.|.|.|.|,.|.|.|W|.|.|.|.|.|.|.|.|.|.|.|.|,.|.|.|.|.|.|.|.|.|.|.|.|.|.|.|.|,.|.|.|.|.|.|.|.|.|.|.|.|.|.|.|.|,.|.|.|.|.|.|.|.|.|.|.|.|.|.|.|.|,.|.|.|.|.|.|.|.|.|.|.|.|.|.|.|.|,.|.|.|.|.|.|.|.|.|.|.|.|.|.|.|.|,.|.|.|.|.|.|.|.|.|.|.|.|.|.|.|.|,.|W|.|.|.|.|.|.|.|.|.|.|.|.|.|.|,.|W|.|.|.|.|.|.|.|.|.|.|.|.|.|.|,F|.|.|W|.|.|.|.|.|.|.|.|.|.|.|.|,.|W|.|W|.|.|.|.|.|.|.|.|.|.|.|.|,.|W|.|.|.|.|.|.|.|.|.|.|.|.|.|.|,.|.|.|.|.|.|.|.|.|.|.|.|.|.|.|.|,.|.|.|.|.|.|.|.|.|.|.|.|.|.|.|.|,.|.|.|.|.|.|.|.|.|.|.|.|.|.|.|.|,.|.|.|.|.|.|.|.|.|.|.|.|.|.|.|.|,.|.|.|.|.|.|.|.|.|.|.|.|.|.|.|.|
.|.|.|.|.|.|.|.|.|.|.|.|.|.|.|.|,.|.|.|.|.|.|.|.|.|.|.|.|.|.|.|.|,.|.|.|.|.|.|.|.|.|.|.|.|.|.|.|.|,.|.|.|.|.|.|.|.|.|.|.|.|.|.|.|.|,.|.|.|.|.|.|.|.|.|.|.|.|.|.|.|.|,.|.|.|.|.|.|.|.|.|.|.|.|.|.|.|.|,.|.|.|.|.|.|.|.|.|.|.|.|.|.|.|.|,.|.|.|.|.|.|.|.|.|.|.|.|.|.|.|.|,.|.|.|.|.|.|.|.|.|.|.|.|.|.|.|.|,.|.|.|.|.|.|.|.|.|.|.|.|.|.|.|.|,F|.|.|W|.|.|.|.|.|.|.|.|.|.|.|.|,.|.|.|W|.|.|.|.|.|.|.|.|.|.|.|.|,F|W|.|W|.|.|.|.|.|.|C|.|.|.|.|.|,F|W|.|.|.|.|.|.|.|.|.|.|.|.|.|.|,.|.|.|W|.|.|.|.|.|.|.|.|.|.|.|.|,F|W|.|W|.|.|.|.|.|.|.|.|.|.|.|.|,F|W|.|.|.|.|.|.|.|.|.|.|.|.|.|.|,.|.|.|W|.|.|.|.|.|.|.|.|.|.|.|.|,F|W|.|W|.|.|D|3|H|.|.|.|.|.|.|.|,F|W|.|.|.|.|.|.|.|.|.|.|.|.|.|.|,F|.|.|W|.|.|.|.|.|.|.|.|.|.|.|.|,F|W|.|W|.|.|D|0|G|.|.|.|.|.|.|.|,F|W|.|.|.|.|.|.|.|.|.|.|.|.|.|.|,.|.|.|W|.|.|.|.|.|.|.|.|.|.|.|.|,.|.|.|.|.|.|.|.|.|.|.|.|.|.|.|.|,.|.|.|.|.|.|.|.|.|.|.|.|.|.|.|.|,.|.|.|.|.|.|.|.|.|.|.|.|.|.|.|.|,.|.|.|.|.|.|.|.|.|.|.|.|.|.|.|.|
.|.|.|.|.|.|.|.|.|.|.|.|.|.|.|.|,.|.|.|.|.|.|.|.|.|.|.|.|.|.|.|.|,.|.|.|.|.|.|.|.|.|.|.|.|.|.|.|.|,.|.|.|.|.|.|.|.|.|.|.|.|.|.|.|.|,.|.|.|.|.|.|.|.|.|.|.|.|.|.|.|.|,.|.|.|.|.|.|.|.|.|.|.|.|.|.|.|.|,.|.|.|.|.|.|.|.|.|.|.|.|.|.|.|.|,.|.|.|.|.|.|.|.|.|.|.|.|.|.|.|.|,.|.|.|.|.|.|.|.|.|.|.|.|.|.|.|.|,.|.|.|.|.|.|.|.|.|.|.|.|.|.|.|.|,F|.|.|W|.|.|.|.|.|.|.|.|.|.|.|.|,.|.|.|W|.|.|.|.|.|.|.|.|.|.|.|.|,F|.|.|W|.|.|.|3|G|.|.|.|.|.|.|.|,F|.|.|.|.|.|.|.|.|.|.|.|.|.|.|.|,.|.|.|W|.|.|.|.|.|.|.|.|.|.|.|.|,F|.|.|W|.|.|.|3|F|.|.|.|.|.|.|.|,F|.|.|.|.|.|.|.|.|.|.|.|.|.|.|.|,.|.|.|W|.|.|.|.|.|.|.|.|.|.|.|.|,F|.|.|W|.|.|.|.|.|.|.|.|.|.|.|.|,F|W|.|W|.|.|.|.|.|.|.|.|.|.|.|.|,F|.|.|.|.|.|.|.|.|.|.|.|3|.|.|.|,F|W|.|.|.|.|.|.|.|.|.|.|.|.|.|.|,F|.|.|W|.|.|.|.|.|.|.|.|.|.|.|.|,F|W|.|W|.|.|.|.|.|.|.|.|.|.|.|.|,F|W|.|.|.|.|.|.|.|.|.|.|.|.|.|.|,.|.|.|W|.|.|.|.|.|.|.|.|.|.|.|.|,.|.|.|.|.|.|.|.|.|.|.|.|.|.|.|.|,.|.|.|.|.|.|.|.|.|.|.|.|.|.|.|.|
.|.|.|.|.|.|.|.|.|.|.|.|.|.|.|.|,.|.|.|.|.|.|.|.|.|.|.|.|.|.|.|.|,.|.|.|.|.|.|.|.|.|.|.|.|.|.|.|.|,.|.|.|.|.|.|.|.|.|.|.|.|.|.|.|.|,.|.|.|.|.|.|.|.|.|.|.|.|.|.|.|.|,.|.|.|.|.|.|.|.|.|.|.|.|.|.|.|.|,.|.|.|.|.|.|.|.|.|.|.|.|.|.|.|.|,.|.|.|.|.|.|.|.|.|.|.|.|.|.|.|.|,.|.|.|.|.|.|.|.|.|.|.|.|.|.|.|.|,.|.|.|.|.|.|.|.|.|.|.|.|.|.|.|.|,F|.|.|W|.|.|.|.|.|.|.|.|.|.|.|.|,F|W|.|.|.|.|.|.|.|.|.|.|.|.|.|.|,F|W|.|.|.|.|.|.|.|.|.|.|.|.|.|.|,F|W|D|.|.|.|.|.|.|.|.|.|.|.|.|.|,F|W|.|.|.|.|.|.|.|.|.|.|.|.|.|.|,F|W|.|.|.|.|.|.|.|.|.|.|.|.|.|.|,F|W|D|.|.|.|.|.|.|.|.|.|.|.|.|.|,F|W|.|.|.|.|.|.|.|.|.|.|.|.|.|.|,F|W|D|.|.|.|.|.|.|.|.|.|.|.|.|.|,F|.|.|.|.|.|.|2|G|.|.|.|.|.|.|.|,F|.|.|.|.|.|.|.|.|.|.|.|.|.|.|.|,F|.|.|.|.|.|.|2|G|.|.|.|.|.|.|.|,F|W|D|.|.|.|.|.|.|.|.|.|.|.|.|.|,F|.|.|W|D|.|.|.|.|.|.|.|.|.|.|.|,F|.|.|.|.|.|.|.|.|.|.|.|.|.|.|.|,.|.|.|W|.|.|.|.|.|.|.|.|.|.|.|.|,.|.|.|.|.|.|.|.|.|.|.|.|.|.|.|.|,.|.|.|.|.|.|.|.|.|.|.|.|.|.|.|.|
.|.|.|.|.|.|.|.|.|.|.|.|.|.|.|.|,.|.|.|.|.|.|.|.|.|.|.|.|.|.|.|.|,.|.|.|.|.|.|.|.|.|.|.|.|.|.|.|.|,.|.|.|.|.|.|.|.|.|.|.|.|.|.|.|.|,.|.|.|.|.|.|.|.|.|.|.|.|.|.|.|.|,.|.|.|.|.|.|.|.|.|.|.|.|.|.|.|.|,.|.|.|.|.|.|.|.|.|.|.|.|.|.|.|.|,.|.|.|.|.|.|.|.|.|.|.|.|.|.|.|.|,.|.|.|.|.|.|.|.|.|.|.|.|.|.|.|.|,.|.|.|.|.|.|.|.|.|.|.|.|.|.|.|.|,F|.|.|W|.|.|.|.|.|.|.|.|.|.|.|.|,.|W|.|W|.|.|.|.|.|.|.|.|.|.|.|.|,F|W|.|W|.|.|.|.|.|.|.|.|.|.|.|.|,F|W|D|.|.|.|.|.|.|.|.|.|.|.|.|.|,.|W|.|W|.|.|.|.|.|.|.|.|.|.|.|.|,F|W|.|W|.|.|.|.|.|.|.|.|.|.|.|.|,F|W|D|.|.|.|.|.|.|.|.|.|.|.|.|.|,.|W|.|W|.|.|.|.|.|.|.|.|.|.|.|.|,F|W|.|W|.|.|.|.|.|.|.|.|.|.|.|.|,F|W|.|.|.|.|.|.|.|.|.|.|.|.|.|.|,F|.|.|W|.|.|.|.|.|.|.|.|.|.|.|.|,F|W|.|W|.|.|.|.|.|.|.|.|.|.|.|.|,F|W|.|.|.|.|.|.|.|.|.|.|.|.|.|.|,F|.|.|W|.|.|.|.|.|.|.|.|.|.|.|.|,F|.|.|.|.|.|.|.|.|.|.|.|.|.|.|.|,.|.|.|W|.|.|.|.|.|.|.|.|.|.|.|.|,.|.|.|.|.|.|.|.|.|.|.|.|.|.|.|.|,.|.|.|.|.|.|.|.|.|.|.|.|.|.|.|.|
.|.|.|.|.|.|.|.|.|.|.|.|.|.|.|.|,.|.|.|.|.|.|.|.|.|.|.|.|.|.|.|.|,.|.|.|.|.|.|.|.|.|.|.|.|.|.|.|.|,.|.|.|.|.|.|.|.|.|.|.|.|.|.|.|.|,.|.|.|.|.|.|.|.|.|.|.|.|.|.|.|.|,.|.|.|.|.|.|.|.|.|.|.|.|.|.|.|.|,.|.|.|.|.|.|.|.|.|.|.|.|.|.|.|.|,.|.|.|.|.|.|.|.|.|.|.|.|.|.|.|.|,.|.|.|.|.|.|.|.|.|.|.|.|.|.|.|.|,.|.|.|.|.|.|.|.|.|.|.|.|.|.|.|.|,F|.|.|W|.|.|.|.|.|.|.|.|.|.|.|.|,.|.|.|W|.|.|.|.|.|.|.|.|.|.|.|.|,F|.|.|W|.|.|.|2|G|.|.|.|.|.|.|.|,F|.|.|.|.|.|.|.|.|.|G|.|.|.|.|.|,.|.|.|W|.|.|.|.|.|.|.|.|.|.|.|.|,F|.|.|W|.|.|.|.|.|.|D|.|.|.|.|.|,F|.|.|.|.|.|.|.|.|.|.|.|.|.|.|.|,.|.|.|W|.|.|.|.|.|.|.|.|.|.|.|.|,F|.|.|W|.|.|D|.|F|.|.|.|.|.|.|.|,F|.|.|.|.|.|.|.|.|.|.|.|.|.|.|.|,F|.|.|W|D|.|.|.|.|.|.|.|.|.|.|.|,F|.|.|W|D|.|.|.|.|.|.|.|.|.|.|.|,F|.|.|.|.|.|D|.|.|.|F|.|.|.|.|.|,.|W|.|W|.|.|.|.|.|.|.|.|.|.|.|.|,.|W|.|.|.|.|.|.|.|.|.|.|.|.|.|.|,.|.|.|.|.|.|.|.|.|.|.|.|.|.|.|.|,.|.|.|.|.|.|.|.|.|.|.|.|.|.|.|.|,.|.|.|.|.|.|.|.|.|.|.|.|.|.|.|.|
.|.|.|.|.|.|.|.|.|.|.|.|.|.|.|.|,.|.|.|.|.|.|.|.|.|.|.|.|.|.|.|.|,.|.|.|.|.|.|.|.|.|.|.|.|.|.|.|.|,.|.|.|.|.|.|.|.|.|.|.|.|.|.|.|.|,.|.|.|.|.|.|.|.|.|.|.|.|.|.|.|.|,.|.|.|.|.|.|.|.|.|.|.|.|.|.|.|.|,.|.|.|.|.|.|.|.|.|.|.|.|.|.|.|.|,.|.|.|.|.|.|.|.|.|.|.|.|.|.|.|.|,.|.|.|.|.|.|.|.|.|.|.|.|.|.|.|.|,.|.|.|.|.|.|.|.|.|.|.|.|.|.|.|.|,F|.|.|W|.|.|.|.|.|.|.|.|.|.|.|.|,.|.|.|W|.|.|.|.|.|.|.|.|.|.|.|.|,.|W|.|.|.|.|.|.|.|.|.|.|.|.|.|.|,.|W|.|.|.|.|.|.|.|.|.|.|.|.|.|.|,.|.|.|.|.|.|.|.|.|.|.|.|.|.|.|.|,.|W|.|.|.|.|.|.|.|.|.|.|.|.|.|.|,.|W|.|.|.|.|.|.|.|.|.|.|.|.|.|.|,.|.|.|.|.|.|.|.|.|.|.|.|.|.|.|.|,.|W|.|.|.|.|.|.|.|.|.|.|.|.|.|.|,.|W|.|.|.|.|.|.|.|.|.|.|.|.|.|.|,F|.|.|W|.|.|.|.|.|.|.|.|.|.|.|.|,.|W|.|W|.|.|.|.|.|.|.|.|.|.|.|.|,.|W|.|.|.|.|.|.|.|.|.|.|.|.|.|.|,.|.|.|.|.|.|.|.|.|.|.|.|.|.|.|.|,.|.|.|.|.|.|.|.|.|.|.|.|.|.|.|.|,.|.|.|.|.|.|.|.|.|.|.|.|.|.|.|.|,.|.|.|.|.|.|.|.|.|.|.|.|.|.|.|.|,.|.|.|.|.|.|.|.|.|.|.|.|.|.|.|.|
.|.|.|.|.|.|.|.|.|.|.|.|.|.|.|.|,.|.|.|.|.|.|.|.|.|.|.|.|.|.|.|.|,.|.|.|.|.|.|.|.|.|.|.|.|.|.|.|.|,.|.|.|.|.|.|.|.|.|.|.|.|.|.|.|.|,.|.|.|.|.|.|.|.|.|.|.|.|.|.|.|.|,.|.|.|.|.|.|.|.|.|.|.|.|.|.|.|.|,.|.|.|.|.|.|.|.|.|.|.|.|.|.|.|.|,.|.|.|.|.|.|.|.|.|.|.|.|.|.|.|.|,.|.|.|.|.|.|.|.|.|.|.|.|.|.|.|.|,.|.|.|.|.|.|.|.|.|.|.|.|.|.|.|.|,F|.|.|W|.|.|.|.|.|.|D|.|.|.|.|.|,F|W|.|W|.|.|.|.|.|.|.|.|.|.|.|.|,F|W|.|.|.|0|S|.|.|.|.|.|.|.|.|.|,F|W|.|.|.|0|S|.|.|.|.|.|.|.|.|.|,.|.|.|W|.|.|.|.|.|.|.|.|.|.|.|.|,.|.|.|.|.|.|.|.|.|.|.|.|.|.|.|.|,.|.|.|.|.|.|.|.|.|.|.|.|.|.|.|.|,.|.|.|.|.|.|.|.|.|.|.|.|.|.|.|.|,F|W|.|W|.|.|.|.|.|.|A|.|.|.|.|.|,F|W|.|.|.|.|L|0|.|.|.|.|.|.|.|.|,F|.|.|W|.|.|.|.|.|.|.|.|.|.|.|.|,F|W|.|W|.|.|.|.|.|.|.|.|.|.|.|.|,F|W|.|.|.|.|.|.|.|.|.|.|.|.|.|.|,.|.|.|W|.|.|.|.|.|.|.|.|.|.|.|.|,.|.|.|.|.|.|.|.|.|.|.|.|.|.|.|.|,.|.|.|.|.|.|.|.|.|.|.|.|.|.|.|.|,.|.|.|.|.|.|.|.|.|.|.|.|.|.|.|.|,.|.|.|.|.|.|.|.|.|.|.|.|.|.|.|.|
.|.|.|.|.|.|.|.|.|.|.|.|.|.|.|.|,.|.|.|.|.|.|.|.|.|.|.|.|.|.|.|.|,.|.|.|.|.|.|.|.|.|.|.|.|.|.|.|.|,.|.|.|.|.|.|.|.|.|.|.|.|.|.|.|.|,.|.|.|.|.|.|.|.|.|.|.|.|.|.|.|.|,.|.|.|.|.|.|.|.|.|.|.|.|.|.|.|.|,.|.|.|.|.|.|.|.|.|.|.|.|.|.|.|.|,.|.|.|.|.|.|.|.|.|.|.|.|.|.|.|.|,.|.|.|.|.|.|.|.|.|.|.|.|.|.|.|.|,.|.|.|.|.|.|.|.|.|.|.|.|.|.|.|.|,F|.|.|W|.|.|.|.|.|.|.|.|.|.|.|.|,F|.|.|W|.|.|.|0|G|.|.|.|.|.|.|.|,F|.|.|.|.|.|.|.|.|.|.|.|.|.|.|.|,F|.|.|.|.|.|.|.|.|.|.|.|.|.|.|.|,.|.|.|W|.|.|.|.|.|.|.|.|.|.|.|.|,.|.|.|.|.|.|.|.|.|.|.|.|.|.|.|.|,.|.|.|.|.|.|.|.|.|.|.|.|.|.|.|.|,.|.|.|.|.|.|.|.|.|.|.|.|.|.|.|.|,F|.|.|W|.|.|D|.|.|.|.|.|.|.|.|.|,F|.|.|.|.|.|.|.|.|.|.|.|.|.|.|.|,F|.|.|W|D|.|.|.|.|.|.|.|.|.|.|.|,F|.|.|W|D|.|.|1|H|.|.|.|.|.|.|.|,F|.|.|.|.|.|D|.|.|.|.|.|.|.|.|.|,.|.|.|W|.|.|.|.|.|.|.|.|.|.|.|.|,.|.|.|.|.|.|.|.|.|.|.|.|.|.|.|.|,.|.|.|.|.|.|.|.|.|.|.|.|.|.|.|.|,.|.|.|.|.|.|.|.|.|.|.|.|.|.|.|.|,.|.|.|.|.|.|.|.|.|.|.|.|.|.|.|.|
.|.|.|.|.|.|.|.|.|.|.|.|.|.|.|.|,.|.|.|.|.|.|.|.|.|.|.|.|.|.|.|.|,.|.|.|.|.|.|.|.|.|.|.|.|.|.|.|.|,.|.|.|.|.|.|.|.|.|.|.|.|.|.|.|.|,.|.|.|.|.|.|.|.|.|.|.|.|.|.|.|.|,.|.|.|.|.|.|.|.|.|.|.|.|.|.|.|.|,.|.|.|.|.|.|.|.|.|.|.|.|.|.|.|.|,.|.|.|.|.|.|.|.|.|.|.|.|.|.|.|.|,.|.|.|.|.|.|.|.|.|.|.|.|.|.|.|.|,.|.|.|.|.|.|.|.|.|.|.|.|.|.|.|.|,F|.|.|W|.|.|.|.|.|.|.|.|.|.|.|.|,F|.|.|W|D|.|.|.|.|.|.|.|.|.|.|.|,F|.|.|.|.|.|.|.|.|.|.|.|.|.|.|.|,F|.|.|.|.|.|.|1|H|.|.|.|.|.|.|.|,.|.|.|W|.|.|.|.|.|.|.|.|.|.|.|.|,.|.|.|.|.|.|.|.|.|.|.|.|.|.|.|.|,.|.|.|.|.|.|.|.|.|.|.|.|.|.|.|.|,.|.|.|.|.|.|.|.|.|.|.|.|.|.|.|.|,.|W|.|.|.|.|.|.|.|.|.|.|.|.|.|.|,.|W|.|.|.|.|.|.|.|.|.|.|.|.|.|.|,F|.|.|W|.|.|.|.|.|.|.|.|.|.|.|.|,.|W|.|W|.|.|.|.|.|.|.|.|.|.|.|.|,.|W|.|.|.|.|.|.|.|.|.|.|.|.|.|.|,.|.|.|.|.|.|.|.|.|.|.|.|.|.|.|.|,.|.|.|.|.|.|.|.|.|.|.|.|.|.|.|.|,.|.|.|.|.|.|.|.|.|.|.|.|.|.|.|.|,.|.|.|.|.|.|.|.|.|.|.|.|.|.|.|.|,.|.|.|.|.|.|.|.|.|.|.|.|.|.|.|.|
.|.|.|.|.|.|.|.|.|.|.|.|.|.|.|.|,.|.|.|.|.|.|.|.|.|.|.|.|.|.|.|.|,.|.|.|.|.|.|.|.|.|.|.|.|.|.|.|.|,.|.|.|.|.|.|.|.|.|.|.|.|.|.|.|.|,.|.|.|.|.|.|.|.|.|.|.|.|.|.|.|.|,.|.|.|.|.|.|.|.|.|.|.|.|.|.|.|.|,.|.|.|.|.|.|.|.|.|.|.|.|.|.|.|.|,.|.|.|.|.|.|.|.|.|.|.|.|.|.|.|.|,.|.|.|.|.|.|.|.|.|.|.|.|.|.|.|.|,.|.|.|.|.|.|.|.|.|.|.|.|.|.|.|.|,F|.|.|W|.|.|.|.|.|.|.|.|.|.|.|.|,F|.|.|W|D|.|.|.|.|.|.|.|.|.|.|.|,F|.|.|.|.|.|.|.|.|.|.|.|.|.|.|.|,F|.|.|.|.|.|.|1|H|.|.|.|.|.|.|.|,F|W|.|W|D|.|.|1|C|.|.|.|4|.|.|.|,.|.|.|W|.|.|.|.|.|.|.|.|.|.|.|.|,.|.|.|.|.|.|.|.|.|.|.|.|.|.|.|.|,.|.|.|.|.|.|.|.|.|.|.|.|.|.|.|.|,F|W|.|W|.|.|.|3|G|.|.|.|.|.|.|.|,F|W|.|.|.|.|.|.|.|.|.|.|.|.|.|.|,F|.|.|W|.|.|.|.|.|.|.|.|.|.|.|.|,F|W|.|W|.|.|.|.|.|.|.|.|.|.|.|.|,F|W|.|.|.|.|.|.|.|.|.|.|.|.|.|.|,.|.|.|W|.|.|.|.|.|.|.|.|.|.|.|.|,.|.|.|.|.|.|.|.|.|.|.|.|.|.|.|.|,.|.|.|.|.|.|.|.|.|.|.|.|.|.|.|.|,.|.|.|.|.|.|.|.|.|.|.|.|.|.|.|.|,.|.|.|.|.|.|.|.|.|.|.|.|.|.|.|.|
.|.|.|.|.|.|.|.|.|.|.|.|.|.|.|.|,.|.|.|.|.|.|.|.|.|.|.|.|.|.|.|.|,.|.|.|.|.|.|.|.|.|.|.|.|.|.|.|.|,.|.|.|.|.|.|.|.|.|.|.|.|.|.|.|.|,.|.|.|.|.|.|.|.|.|.|.|.|.|.|.|.|,.|.|.|.|.|.|.|.|.|.|.|.|.|.|.|.|,.|.|.|.|.|.|.|.|.|.|.|.|.|.|.|.|,.|.|.|.|.|.|.|.|.|.|.|.|.|.|.|.|,.|.|.|.|.|.|.|.|.|.|.|.|.|.|.|.|,.|.|.|.|.|.|.|.|.|.|.|.|.|.|.|.|,F|.|.|W|.|.|.|.|.|.|.|.|.|.|.|.|,F|.|.|W|.|.|.|2|G|.|.|.|.|.|.|.|,F|.|.|.|.|.|.|.|.|.|.|.|.|.|.|.|,F|.|.|.|.|.|.|.|.|.|.|.|.|.|.|.|,F|.|.|W|.|.|.|2|C|.|.|.|.|.|Q|.|,.|.|.|W|.|.|.|.|.|.|.|.|.|.|.|.|,.|.|.|.|.|.|.|.|.|.|.|.|.|.|.|.|,.|.|.|.|.|.|.|.|.|.|.|.|.|.|.|.|,F|.|.|W|.|.|D|.|.|.|.|.|.|.|.|.|,F|.|.|.|.|.|L|2|.|.|.|.|.|.|.|.|,F|.|.|W|D|.|.|.|.|.|.|.|.|.|.|.|,F|.|.|W|D|.|.|.|.|.|B|.|.|.|.|.|,F|.|.|.|.|.|D|.|.|.|.|.|.|.|.|.|,.|.|.|W|.|.|.|.|.|.|.|.|.|.|.|.|,.|.|.|.|.|.|.|.|.|.|.|.|.|.|.|.|,.|.|.|.|.|.|.|.|.|.|.|.|.|.|.|.|,.|.|.|.|.|.|.|.|.|.|.|.|.|.|.|.|,.|.|.|.|.|.|.|.|.|.|.|.|.|.|.|.|
.|.|.|.|.|.|.|.|.|.|.|.|.|.|.|.|,.|.|.|.|.|.|.|.|.|.|.|.|.|.|.|.|,.|.|.|.|.|.|.|.|.|.|.|.|.|.|.|.|,.|.|.|.|.|.|.|.|.|.|.|.|.|.|.|.|,.|.|.|.|.|.|.|.|.|.|.|.|.|.|.|.|,.|.|.|.|.|.|.|.|.|.|.|.|.|.|.|.|,.|.|.|.|.|.|.|.|.|.|.|.|.|.|.|.|,.|.|.|.|.|.|.|.|.|.|.|.|.|.|.|.|,.|.|.|.|.|.|.|.|.|.|.|.|.|.|.|.|,.|.|.|.|.|.|.|.|.|.|.|.|.|.|.|.|,F|.|.|W|.|.|.|.|.|.|.|.|.|.|.|.|,F|.|.|W|.|.|.|.|.|.|.|.|.|.|.|.|,F|.|.|.|.|2|S|.|.|.|.|.|.|.|.|.|,F|.|.|.|.|2|S|.|.|.|.|.|.|.|.|.|,.|W|.|W|.|.|.|.|.|.|.|.|.|.|.|.|,.|.|.|.|.|.|.|.|.|.|.|.|.|.|.|.|,.|.|.|.|.|.|.|.|.|.|.|.|.|.|.|.|,.|.|.|.|.|.|.|.|.|.|.|.|.|.|.|.|,.|W|.|.|.|.|.|.|.|.|.|.|.|.|.|.|,.|W|.|.|.|.|.|.|.|.|.|.|.|.|.|.|,F|.|.|W|.|.|.|.|.|.|.|.|.|.|.|.|,.|W|.|W|.|.|.|.|.|.|.|.|.|.|.|.|,.|W|.|.|.|.|.|.|.|.|.|.|.|.|.|.|,.|.|.|.|.|.|.|.|.|.|.|.|.|.|.|.|,.|.|.|.|.|.|.|.|.|.|.|.|.|.|.|.|,.|.|.|.|.|.|.|.|.|.|.|.|.|.|.|.|,.|.|.|.|.|.|.|.|.|.|.|.|.|.|.|.|,.|.|.|.|.|.|.|.|.|.|.|.|.|.|.|.|
.|.|.|.|.|.|.|.|.|.|.|.|.|.|.|.|,.|.|.|.|.|.|.|.|.|.|.|.|.|.|.|.|,.|.|.|.|.|.|.|.|.|.|.|.|.|.|.|.|,.|.|.|.|.|.|.|.|.|.|.|.|.|.|.|.|,.|.|.|.|.|.|.|.|.|.|.|.|.|.|.|.|,.|.|.|.|.|.|.|.|.|.|.|.|.|.|.|.|,.|.|.|.|.|.|.|.|.|.|.|.|.|.|.|.|,.|.|.|.|.|.|.|.|.|.|.|.|.|.|.|.|,.|.|.|.|.|.|.|.|.|.|.|.|.|.|.|.|,.|.|.|.|.|.|.|.|.|.|.|.|.|.|.|.|,F|.|.|W|.|.|.|.|.|.|.|.|.|.|.|.|,.|W|.|W|.|.|.|.|.|.|.|.|.|.|.|.|,.|W|.|.|.|.|.|.|.|.|.|.|.|.|.|.|,.|W|.|.|.|.|.|.|.|.|.|.|.|.|.|.|,.|.|.|.|.|.|.|.|.|.|.|.|.|.|.|.|,.|.|.|.|.|.|.|.|.|.|.|.|.|.|.|.|,.|.|.|.|.|.|.|.|.|.|.|.|.|.|.|.|,.|.|.|.|.|.|.|.|.|.|.|.|.|.|.|.|,.|.|.|.|.|.|.|.|.|.|.|.|.|.|.|.|,.|.|.|.|.|.|.|.|.|.|.|.|.|.|.|.|,F|.|.|W|.|.|.|.|.|.|A|.|.|.|.|.|,.|.|.|W|.|.|.|.|.|.|.|.|.|.|.|.|,.|.|.|.|.|.|.|.|.|.|.|.|.|.|.|.|,.|.|.|.|.|.|.|.|.|.|.|.|.|.|.|.|,.|.|.|.|.|.|.|.|.|.|.|.|.|.|.|.|,.|.|.|.|.|.|.|.|.|.|.|.|.|.|.|.|,.|.|.|.|.|.|.|.|.|.|.|.|.|.|.|.|,.|.|.|.|.|.|.|.|.|.|.|.|.|.|.|.|
.|.|.|.|.|.|.|.|.|.|.|.|.|.|.|.|,.|.|.|.|.|.|.|.|.|.|.|.|.|.|.|.|,.|.|.|.|.|.|.|.|.|.|.|.|.|.|.|.|,.|.|.|.|.|.|.|.|.|.|.|.|.|.|.|.|,.|.|.|.|.|.|.|.|.|.|.|.|.|.|.|.|,.|.|.|.|.|.|.|.|.|.|.|.|.|.|.|.|,.|.|.|.|.|.|.|.|.|.|.|.|.|.|.|.|,.|.|.|.|.|.|.|.|.|.|.|.|.|.|.|.|,.|.|.|.|.|.|.|.|.|.|.|.|.|.|.|.|,.|.|.|.|.|.|.|.|.|.|.|.|.|.|.|.|,.|W|.|.|.|.|.|.|.|.|.|.|.|.|.|.|,.|.|.|.|.|.|.|.|.|.|.|.|.|.|.|.|,.|.|.|.|.|.|.|.|.|.|.|.|.|.|.|.|,.|.|.|.|.|.|.|.|.|.|.|.|.|.|.|.|,.|.|.|.|.|.|.|.|.|.|.|.|.|.|.|.|,.|.|.|.|.|.|.|.|.|.|.|.|.|.|.|.|,.|.|.|.|.|.|.|.|.|.|.|.|.|.|.|.|,.|.|.|.|.|.|.|.|.|.|.|.|.|.|.|.|,.|.|.|.|.|.|.|.|.|.|.|.|.|.|.|.|,.|.|.|.|.|.|.|.|.|.|.|.|.|.|.|.|,.|W|.|.|.|.|.|.|.|.|.|.|.|.|.|.|,.|.|.|.|.|.|.|.|.|.|.|.|.|.|.|.|,.|.|.|.|.|.|.|.|.|.|.|.|.|.|.|.|,.|.|.|.|.|.|.|.|.|.|.|.|.|.|.|.|,.|.|.|.|.|.|.|.|.|.|.|.|.|.|.|.|,.|.|.|.|.|.|.|.|.|.|.|.|.|.|.|.|,.|.|.|.|.|.|.|.|.|.|.|.|.|.|.|.|,.|.|.|.|.|.|.|.|.|.|.|.|.|.|.|.|
.|.|.|.|.|.|.|.|.|.|.|.|.|.|.|.|,.|.|.|.|.|.|.|.|.|.|.|.|.|.|.|.|,.|.|.|.|.|.|.|.|.|.|.|.|.|.|.|.|,.|.|.|.|.|.|.|.|.|.|.|.|.|.|.|.|,.|.|.|.|.|.|.|.|.|.|.|.|.|.|.|.|,.|.|.|.|.|.|.|.|.|.|.|.|.|.|.|.|,.|.|.|.|.|.|.|.|.|.|.|.|.|.|.|.|,.|.|.|.|.|.|.|.|.|.|.|.|.|.|.|.|,.|.|.|.|.|.|.|.|.|.|.|.|.|.|.|.|,.|.|.|.|.|.|.|.|.|.|.|.|.|.|.|.|,.|.|.|.|.|.|.|.|.|.|.|.|.|.|.|.|,.|.|.|.|.|.|.|.|.|.|.|.|.|.|.|.|,.|.|.|.|.|.|.|.|.|.|.|.|.|.|.|.|,.|.|.|.|.|.|.|.|.|.|.|.|.|.|.|.|,.|.|.|.|.|.|.|.|.|.|.|.|.|.|.|.|,.|.|.|.|.|.|.|.|.|.|.|.|.|.|.|.|,.|.|.|.|.|.|.|.|.|.|.|.|.|.|.|.|,.|.|.|.|.|.|.|.|.|.|.|.|.|.|.|.|,.|.|.|.|.|.|.|.|.|.|.|.|.|.|.|.|,.|.|.|.|.|.|.|.|.|.|.|.|.|.|.|.|,.|.|.|.|.|.|.|.|.|.|.|.|.|.|.|.|,.|.|.|.|.|.|.|.|.|.|.|.|.|.|.|.|,.|.|.|.|.|.|.|.|.|.|.|.|.|.|.|.|,.|.|.|.|.|.|.|.|.|.|.|.|.|.|.|.|,.|.|.|.|.|.|.|.|.|.|.|.|.|.|.|.|,.|.|.|.|.|.|.|.|.|.|.|.|.|.|.|.|,.|.|.|.|.|.|.|.|.|.|.|.|.|.|.|.|,.|.|.|.|.|.|.|.|.|.|.|.|.|.|.|.|
.|.|.|.|.|.|.|.|.|.|.|.|.|.|.|.|,.|.|.|.|.|.|.|.|.|.|.|.|.|.|.|.|,.|.|.|.|.|.|.|.|.|.|.|.|.|.|.|.|,.|.|.|.|.|.|.|.|.|.|.|.|.|.|.|.|,.|.|.|.|.|.|.|.|.|.|.|.|.|.|.|.|,.|.|.|.|.|.|.|.|.|.|.|.|.|.|.|.|,.|.|.|.|.|.|.|.|.|.|.|.|.|.|.|.|,.|.|.|.|.|.|.|.|.|.|.|.|.|.|.|.|,.|.|.|.|.|.|.|.|.|.|.|.|.|.|.|.|,.|.|.|.|.|.|.|.|.|.|.|.|.|.|.|.|,.|.|.|.|.|.|.|.|.|.|.|.|.|.|.|.|,.|.|.|.|.|.|.|.|.|.|.|.|.|.|.|.|,.|.|.|.|.|.|.|.|.|.|.|.|.|.|.|.|,.|.|.|.|.|.|.|.|.|.|.|.|.|.|.|.|,.|.|.|.|.|.|.|.|.|.|.|.|.|.|.|.|,.|.|.|.|.|.|.|.|.|.|.|.|.|.|.|.|,.|.|.|.|.|.|.|.|.|.|.|.|.|.|.|.|,.|.|.|.|.|.|.|.|.|.|.|.|.|.|.|.|,.|.|.|.|.|.|.|.|.|.|.|.|.|.|.|.|,.|.|.|.|.|.|.|.|.|.|.|.|.|.|.|.|,.|.|.|.|.|.|.|.|.|.|.|.|.|.|.|.|,.|.|.|.|.|.|.|.|.|.|.|.|.|.|.|.|,.|.|.|.|.|.|.|.|.|.|.|.|.|.|.|.|,.|.|.|.|.|.|.|.|.|.|.|.|.|.|.|.|,.|.|.|.|.|.|.|.|.|.|.|.|.|.|.|.|,.|.|.|.|.|.|.|.|.|.|.|.|.|.|.|.|,.|.|.|.|.|.|.|.|.|.|.|.|.|.|.|.|,.|.|.|.|.|.|.|.|.|.|.|.|.|.|.|.|
.|.|.|.|.|.|.|.|.|.|.|.|.|.|.|.|,.|.|.|.|.|.|.|.|.|.|.|.|.|.|.|.|,.|.|.|.|.|.|.|.|.|.|.|.|.|.|.|.|,.|.|.|.|.|.|.|.|.|.|.|.|.|.|.|.|,.|.|.|.|.|.|.|.|.|.|.|.|.|.|.|.|,.|.|.|.|.|.|.|.|.|.|.|.|.|.|.|.|,.|.|.|.|.|.|.|.|.|.|.|.|.|.|.|.|,.|.|.|.|.|.|.|.|.|.|.|.|.|.|.|.|,.|.|.|.|.|.|.|.|.|.|.|.|.|.|.|.|,.|.|.|.|.|.|.|.|.|.|.|.|.|.|.|.|,.|.|.|.|.|.|.|.|.|.|.|.|.|.|.|.|,.|.|.|.|.|.|.|.|.|.|.|.|.|.|.|.|,.|.|.|.|.|.|.|.|.|.|.|.|.|.|.|.|,.|.|.|.|.|.|.|.|.|.|.|.|.|.|.|.|,.|.|.|.|.|.|.|.|.|.|.|.|.|.|.|.|,.|.|.|.|.|.|.|.|.|.|.|.|.|.|.|.|,.|.|.|.|.|.|.|.|.|.|.|.|.|.|.|.|,.|.|.|.|.|.|.|.|.|.|.|.|.|.|.|.|,.|.|.|.|.|.|.|.|.|.|.|.|.|.|.|.|,.|.|.|.|.|.|.|.|.|.|.|.|.|.|.|.|,.|.|.|.|.|.|.|.|.|.|.|.|.|.|.|.|,.|.|.|.|.|.|.|.|.|.|.|.|.|.|.|.|,.|.|.|.|.|.|.|.|.|.|.|.|.|.|.|.|,.|.|.|.|.|.|.|.|.|.|.|.|.|.|.|.|,.|.|.|.|.|.|.|.|.|.|.|.|.|.|.|.|,.|.|.|.|.|.|.|.|.|.|.|.|.|.|.|.|,.|.|.|.|.|.|.|.|.|.|.|.|.|.|.|.|,.|.|.|.|.|.|.|.|.|.|.|.|.|.|.|.|
.|.|.|.|.|.|.|.|.|.|.|.|.|.|.|.|,.|.|.|.|.|.|.|.|.|.|.|.|.|.|.|.|,.|.|.|.|.|.|.|.|.|.|.|.|.|.|.|.|,.|.|.|.|.|.|.|.|.|.|.|.|.|.|.|.|,.|.|.|.|.|.|.|.|.|.|.|.|.|.|.|.|,.|.|.|.|.|.|.|.|.|.|.|.|.|.|.|.|,.|.|.|.|.|.|.|.|.|.|.|.|.|.|.|.|,.|.|.|.|.|.|.|.|.|.|.|.|.|.|.|.|,.|.|.|.|.|.|.|.|.|.|.|.|.|.|.|.|,.|.|.|.|.|.|.|.|.|.|.|.|.|.|.|.|,.|.|.|.|.|.|.|.|.|.|.|.|.|.|.|.|,.|.|.|.|.|.|.|.|.|.|.|.|.|.|.|.|,.|.|.|.|.|.|.|.|.|.|.|.|.|.|.|.|,.|.|.|.|.|.|.|.|.|.|.|.|.|.|.|.|,.|.|.|.|.|.|.|.|.|.|.|.|.|.|.|.|,.|.|.|.|.|.|.|.|.|.|.|.|.|.|.|.|,.|.|.|.|.|.|.|.|.|.|.|.|.|.|.|.|,.|.|.|.|.|.|.|.|.|.|.|.|.|.|.|.|,.|.|.|.|.|.|.|.|.|.|.|.|.|.|.|.|,.|.|.|.|.|.|.|.|.|.|.|.|.|.|.|.|,.|.|.|.|.|.|.|.|.|.|.|.|.|.|.|.|,.|.|.|.|.|.|.|.|.|.|.|.|.|.|.|.|,.|.|.|.|.|.|.|.|.|.|.|.|.|.|.|.|,.|.|.|.|.|.|.|.|.|.|.|.|.|.|.|.|,.|.|.|.|.|.|.|.|.|.|.|.|.|.|.|.|,.|.|.|.|.|.|.|.|.|.|.|.|.|.|.|.|,.|.|.|.|.|.|.|.|.|.|.|.|.|.|.|.|,.|.|.|.|.|.|.|.|.|.|.|.|.|.|.|.|
.|.|.|.|.|.|.|.|.|.|.|.|.|.|.|.|,.|.|.|.|.|.|.|.|.|.|.|.|.|.|.|.|,.|.|.|.|.|.|.|.|.|.|.|.|.|.|.|.|,.|.|.|.|.|.|.|.|.|.|.|.|.|.|.|.|,.|.|.|.|.|.|.|.|.|.|.|.|.|.|.|.|,.|.|.|.|.|.|.|.|.|.|.|.|.|.|.|.|,.|.|.|.|.|.|.|.|.|.|.|.|.|.|.|.|,.|.|.|.|.|.|.|.|.|.|.|.|.|.|.|.|,.|.|.|.|.|.|.|.|.|.|.|.|.|.|.|.|,.|.|.|.|.|.|.|.|.|.|.|.|.|.|.|.|,.|.|.|.|.|.|.|.|.|.|.|.|.|.|.|.|,.|.|.|.|.|.|.|.|.|.|.|.|.|.|.|.|,.|.|.|.|.|.|.|.|.|.|.|.|.|.|.|.|,.|.|.|.|.|.|.|.|.|.|.|.|.|.|.|.|,.|.|.|.|.|.|.|.|.|.|.|.|.|.|.|.|,.|.|.|.|.|.|.|.|.|.|.|.|.|.|.|.|,.|.|.|.|.|.|.|.|.|.|.|.|.|.|.|.|,.|.|.|.|.|.|.|.|.|.|.|.|.|.|.|.|,.|.|.|.|.|.|.|.|.|.|.|.|.|.|.|.|,.|.|.|.|.|.|.|.|.|.|.|.|.|.|.|.|,.|.|.|.|.|.|.|.|.|.|.|.|.|.|.|.|,.|.|.|.|.|.|.|.|.|.|.|.|.|.|.|.|,.|.|.|.|.|.|.|.|.|.|.|.|.|.|.|.|,.|.|.|.|.|.|.|.|.|.|.|.|.|.|.|.|,.|.|.|.|.|.|.|.|.|.|.|.|.|.|.|.|,.|.|.|.|.|.|.|.|.|.|.|.|.|.|.|.|,.|.|.|.|.|.|.|.|.|.|.|.|.|.|.|.|,.|.|.|.|.|.|.|.|.|.|.|.|.|.|.|.|
