.|.|.|.|.|.|.|.|.|.|.|.|.|.|.|.|,.|.|.|.|.|.|.|.|.|.|.|.|.|.|.|.|,.|.|.|.|.|.|.|.|.|.|.|.|.|.|.|.|,.|.|.|.|.|.|.|.|.|.|.|.|.|.|.|.|,.|.|.|.|.|.|.|.|.|.|.|.|.|.|.|.|,.|.|.|.|.|.|.|.|.|.|.|.|.|.|.|.|,.|.|.|.|.|.|.|.|.|.|.|.|.|.|.|.|,.|.|.|.|.|.|.|.|.|.|.|.|.|.|.|.|,.|.|.|.|.|.|.|.|.|.|.|.|.|.|.|.|,.|.|.|.|.|.|.|.|.|.|.|.|.|.|.|.|,.|.|.|.|.|.|.|.|.|.|.|.|.|.|.|.|,.|.|.|.|.|.|.|.|.|.|.|.|.|.|.|.|,.|.|.|.|.|.|.|.|.|.|.|.|.|.|.|.|,.|.|.|.|.|.|.|.|.|.|.|.|.|.|.|.|,.|.|.|.|.|.|.|.|.|.|.|.|.|.|.|.|,.|.|.|.|.|.|.|.|.|.|.|.|.|.|.|.|,.|.|.|.|.|.|.|.|.|.|.|.|.|.|.|.|,.|.|.|.|.|.|.|.|.|.|.|.|.|.|.|.|,.|.|.|.|.|.|.|.|.|.|.|.|.|.|.|.|,.|.|.|.|.|.|.|.|.|.|.|.|.|.|.|.|,.|.|.|.|.|.|.|.|.|.|.|.|.|.|.|.|,.|.|.|.|.|.|.|.|.|.|.|.|.|.|.|.|,.|.|.|.|.|.|.|.|.|.|.|.|.|.|.|.|,.|.|.|.|.|.|.|.|.|.|.|.|.|.|.|.|,.|.|.|.|.|.|.|.|.|.|.|.|.|.|.|.|,.|.|.|.|.|.|.|.|.|.|.|.|.|.|.|.|,.|.|.|.|.|.|.|.|.|.|.|.|.|.|.|.|,.|.|.|.|.|.|.|.|.|.|.|.|.|.|.|.|
.|.|.|.|.|.|.|.|.|.|.|.|.|.|.|.|,.|.|.|.|.|.|.|.|.|.|.|.|.|.|.|.|,.|.|.|.|.|.|.|.|.|.|.|.|.|.|.|.|,.|.|.|.|.|.|.|.|.|.|.|.|.|.|.|.|,.|.|.|.|.|.|.|.|.|.|.|.|.|.|.|.|,.|.|.|.|.|.|.|.|.|.|.|.|.|.|.|.|,.|.|.|.|.|.|.|.|.|.|.|.|.|.|.|.|,.|.|.|.|.|.|.|.|.|.|.|.|.|.|.|.|,.|.|.|.|.|.|.|.|.|.|.|.|.|.|.|.|,.|.|.|.|.|.|.|.|.|.|.|.|.|.|.|.|,.|.|.|.|.|.|.|.|.|.|.|.|.|.|.|.|,.|.|.|.|.|.|.|.|.|.|.|.|.|.|.|.|,.|.|.|.|.|.|.|.|.|.|.|.|.|.|.|.|,.|.|.|.|.|.|.|.|.|.|.|.|.|.|.|.|,.|.|.|.|.|.|.|.|.|.|.|.|.|.|.|.|,.|.|.|.|.|.|.|.|.|.|.|.|.|.|.|.|,.|.|.|.|.|.|.|.|.|.|.|.|.|.|.|.|,.|.|.|.|.|.|.|.|.|.|.|.|.|.|.|.|,.|.|.|.|.|.|.|.|.|.|.|.|.|.|.|.|,.|.|.|.|.|.|.|.|.|.|.|.|.|.|.|.|,.|.|.|.|.|.|.|.|.|.|.|.|.|.|.|.|,.|.|.|.|.|.|.|.|.|.|.|.|.|.|.|.|,.|.|.|.|.|.|.|.|.|.|.|.|.|.|.|.|,.|.|.|.|.|.|.|.|.|.|.|.|.|.|.|.|,.|.|.|.|.|.|.|.|.|.|.|.|.|.|.|.|,.|.|.|.|.|.|.|.|.|.|.|.|.|.|.|.|,.|.|.|.|.|.|.|.|.|.|.|.|.|.|.|.|,.|.|.|.|.|.|.|.|.|.|.|.|.|.|.|.|
.|.|.|.|.|.|.|.|.|.|.|.|.|.|.|.|,.|.|.|.|.|.|.|.|.|.|.|.|.|.|.|.|,.|.|.|.|.|.|.|.|.|.|.|.|.|.|.|.|,.|.|.|.|.|.|.|.|.|.|.|.|.|.|.|.|,.|.|.|.|.|.|.|.|.|.|.|.|.|.|.|.|,.|.|.|.|.|.|.|.|.|.|.|.|.|.|.|.|,.|.|.|.|.|.|.|.|.|.|.|.|.|.|.|.|,.|.|.|.|.|.|.|.|.|.|.|.|.|.|.|.|,.|.|.|.|.|.|.|.|.|.|.|.|.|.|.|.|,.|.|.|.|.|.|.|.|.|.|.|.|.|.|.|.|,.|.|.|.|.|.|.|.|.|.|.|.|.|.|.|.|,.|.|.|.|.|.|.|.|.|.|.|.|.|.|.|.|,.|.|.|.|.|.|.|.|.|.|.|.|.|.|.|.|,.|.|.|.|.|.|.|.|.|.|.|.|.|.|.|.|,.|.|.|.|.|.|.|.|.|.|.|.|.|.|.|.|,.|.|.|.|.|.|.|.|.|.|.|.|.|.|.|.|,.|.|.|.|.|.|.|.|.|.|.|.|.|.|.|.|,.|.|.|.|.|.|.|.|.|.|.|.|.|.|.|.|,.|.|.|.|.|.|.|.|.|.|.|.|.|.|.|.|,.|.|.|.|.|.|.|.|.|.|.|.|.|.|.|.|,.|.|.|.|.|.|.|.|.|.|.|.|.|.|.|.|,.|.|.|.|.|.|.|.|.|.|.|.|.|.|.|.|,.|.|.|.|.|.|.|.|.|.|.|.|.|.|.|.|,.|.|.|.|.|.|.|.|.|.|.|.|.|.|.|.|,.|.|.|.|.|.|.|.|.|.|.|.|.|.|.|.|,.|.|.|.|.|.|.|.|.|.|.|.|.|.|.|.|,.|.|.|.|.|.|.|.|.|.|.|.|.|.|.|.|,.|.|.|.|.|.|.|.|.|.|.|.|.|.|.|.|
.|.|.|.|.|.|.|.|.|.|.|.|.|.|.|.|,.|.|.|.|.|.|.|.|.|.|.|.|.|.|.|.|,.|.|.|.|.|.|.|.|.|.|.|.|.|.|.|.|,.|.|.|.|.|.|.|.|.|.|.|.|.|.|.|.|,.|.|.|.|.|.|.|.|.|.|.|.|.|.|.|.|,.|.|.|.|.|.|.|.|.|.|.|.|.|.|.|.|,.|.|.|.|.|.|.|.|.|.|.|.|.|.|.|.|,.|.|.|.|.|.|.|.|.|.|.|.|.|.|.|.|,.|.|.|.|.|.|.|.|.|.|.|.|.|.|.|.|,.|.|.|.|.|.|.|.|.|.|.|.|.|.|.|.|,.|.|.|.|.|.|.|.|.|.|.|.|.|.|.|.|,.|.|.|.|.|.|.|.|.|.|.|.|.|.|.|.|,.|.|.|.|.|.|.|.|.|.|.|.|.|.|.|.|,.|.|.|.|.|.|.|.|.|.|.|.|.|.|.|.|,.|.|.|.|.|.|.|.|.|.|.|.|.|.|.|.|,.|.|.|.|.|.|.|.|.|.|.|.|.|.|.|.|,.|.|.|.|.|.|.|.|.|.|.|.|.|.|.|.|,.|.|.|.|.|.|.|.|.|.|.|.|.|.|.|.|,.|.|.|.|.|.|.|.|.|.|.|.|.|.|.|.|,.|.|.|.|.|.|.|.|.|.|.|.|.|.|.|.|,.|.|.|.|.|.|.|.|.|.|.|.|.|.|.|.|,.|.|.|.|.|.|.|.|.|.|.|.|.|.|.|.|,.|.|.|.|.|.|.|.|.|.|.|.|.|.|.|.|,.|.|.|.|.|.|.|.|.|.|.|.|.|.|.|.|,.|.|.|.|.|.|.|.|.|.|.|.|.|.|.|.|,.|.|.|.|.|.|.|.|.|.|.|.|.|.|.|.|,.|.|.|.|.|.|.|.|.|.|.|.|.|.|.|.|,.|.|.|.|.|.|.|.|.|.|.|.|.|.|.|.|
.|.|.|.|.|.|.|.|.|.|.|.|.|.|.|.|,.|.|.|.|.|.|.|.|.|.|.|.|.|.|.|.|,.|.|.|.|.|.|.|.|.|.|.|.|.|.|.|.|,.|.|.|.|.|.|.|.|.|.|.|.|.|.|.|.|,.|.|.|.|.|.|.|.|.|.|.|.|.|.|.|.|,.|.|.|.|.|.|.|.|.|.|.|.|.|.|.|.|,.|.|.|.|.|.|.|.|.|.|.|.|.|.|.|.|,.|.|.|.|.|.|.|.|.|.|.|.|.|.|.|.|,.|.|.|.|.|.|.|.|.|.|.|.|.|.|.|.|,.|.|.|.|.|.|.|.|.|.|.|.|.|.|.|.|,.|.|.|.|.|.|.|.|.|.|.|.|.|.|.|.|,F|B|.|B|.|0|K|.|.|.|.|.|.|.|.|.|,F|B|.|.|.|0|.|0|C|.|.|.|.|.|.|.|,F|B|.|.|.|0|K|.|.|.|.|.|.|.|.|.|,F|B|.|.|.|.|.|1|C|.|.|.|.|.|.|.|,F|B|.|.|.|0|K|.|.|.|.|.|.|.|.|.|,F|B|.|.|.|.|.|1|C|.|.|.|.|.|.|.|,.|.|.|B|.|.|.|.|.|.|.|.|.|.|.|.|,.|.|.|.|.|.|.|.|.|.|.|.|.|.|.|.|,.|.|.|.|.|.|.|.|.|.|.|.|.|.|.|.|,.|.|.|.|.|.|.|.|.|.|.|.|.|.|.|.|,.|.|.|.|.|.|.|.|.|.|.|.|.|.|.|.|,.|.|.|.|.|.|.|.|.|.|.|.|.|.|.|.|,.|.|.|.|.|.|.|.|.|.|.|.|.|.|.|.|,.|.|.|.|.|.|.|.|.|.|.|.|.|.|.|.|,.|.|.|.|.|.|.|.|.|.|.|.|.|.|.|.|,.|.|.|.|.|.|.|.|.|.|.|.|.|.|.|.|,.|.|.|.|.|.|.|.|.|.|.|.|.|.|.|.|
.|.|.|.|.|.|.|.|.|.|.|.|.|.|.|.|,.|.|.|.|.|.|.|.|.|.|.|.|.|.|.|.|,.|.|.|.|.|.|.|.|.|.|.|.|.|.|.|.|,.|.|.|.|.|.|.|.|.|.|.|.|.|.|.|.|,.|.|.|.|.|.|.|.|.|.|.|.|.|.|.|.|,.|.|.|.|.|.|.|.|.|.|.|.|.|.|.|.|,.|.|.|.|.|.|.|.|.|.|.|.|.|.|.|.|,.|.|.|.|.|.|.|.|.|.|.|.|.|.|.|.|,.|.|.|.|.|.|.|.|.|.|.|.|.|.|.|.|,.|.|.|.|.|.|.|.|.|.|.|.|.|.|.|.|,.|.|.|.|.|.|.|.|.|.|.|.|.|.|.|.|,F|.|.|B|.|.|.|.|.|.|.|.|.|.|.|.|,F|.|.|.|.|.|.|.|.|.|.|.|.|.|.|.|,F|.|.|.|.|.|.|.|.|.|.|.|.|.|.|.|,F|.|.|.|.|.|.|.|.|.|.|.|.|.|.|.|,F|.|.|.|.|.|.|.|.|.|.|.|.|.|.|.|,F|.|.|.|.|.|.|.|.|.|.|.|.|.|.|.|,.|.|.|B|.|.|.|.|.|.|.|.|.|.|.|.|,.|.|.|.|.|.|.|.|.|.|.|.|.|.|.|.|,.|.|.|.|.|.|.|.|.|.|.|.|.|.|.|.|,.|.|.|.|.|.|.|.|.|.|.|.|.|.|.|.|,.|.|.|.|.|.|.|.|.|.|.|.|.|.|.|.|,.|.|.|.|.|.|.|.|.|.|.|.|.|.|.|.|,.|.|.|.|.|.|.|.|.|.|.|.|.|.|.|.|,.|.|.|.|.|.|.|.|.|.|.|.|.|.|.|.|,.|.|.|.|.|.|.|.|.|.|.|.|.|.|.|.|,.|.|.|.|.|.|.|.|.|.|.|.|.|.|.|.|,.|.|.|.|.|.|.|.|.|.|.|.|.|.|.|.|
.|.|.|.|.|.|.|.|.|.|.|.|.|.|.|.|,.|.|.|.|.|.|.|.|.|.|.|.|.|.|.|.|,.|.|.|.|.|.|.|.|.|.|.|.|.|.|.|.|,.|.|.|.|.|.|.|.|.|.|.|.|.|.|.|.|,.|.|.|.|.|.|.|.|.|.|.|.|.|.|.|.|,.|.|.|.|.|.|.|.|.|.|.|.|.|.|.|.|,.|.|.|.|.|.|.|.|.|.|.|.|.|.|.|.|,.|.|.|.|.|.|.|.|.|.|.|.|.|.|.|.|,.|.|.|.|.|.|.|.|.|.|.|.|.|.|.|.|,.|.|.|.|.|.|.|.|.|.|.|.|.|.|.|.|,.|.|.|.|.|.|.|.|.|.|.|.|.|.|.|.|,F|.|.|B|.|.|.|.|.|.|.|.|.|.|.|.|,F|.|.|.|.|.|.|.|.|.|.|.|.|.|.|.|,F|.|.|.|.|.|.|.|.|.|.|.|.|.|.|.|,F|.|.|.|.|.|.|.|.|.|.|.|.|.|.|.|,F|.|.|.|.|.|.|.|.|.|.|.|.|.|.|.|,F|.|.|.|.|.|.|.|.|.|.|.|4|.|.|.|,F|B|.|B|D|.|.|1|F|.|.|.|.|.|.|.|,.|.|.|B|.|.|.|.|.|.|.|.|.|.|.|.|,.|.|.|.|.|.|.|.|.|.|.|.|.|.|.|.|,.|.|.|.|.|.|.|.|.|.|.|.|.|.|.|.|,.|.|.|.|.|.|.|.|.|.|.|.|.|.|.|.|,.|.|.|.|.|.|.|.|.|.|.|.|.|.|.|.|,.|.|.|.|.|.|.|.|.|.|.|.|.|.|.|.|,.|.|.|.|.|.|.|.|.|.|.|.|.|.|.|.|,.|.|.|.|.|.|.|.|.|.|.|.|.|.|.|.|,.|.|.|.|.|.|.|.|.|.|.|.|.|.|.|.|,.|.|.|.|.|.|.|.|.|.|.|.|.|.|.|.|
.|.|.|.|.|.|.|.|.|.|.|.|.|.|.|.|,.|.|.|.|.|.|.|.|.|.|.|.|.|.|.|.|,.|.|.|.|.|.|.|.|.|.|.|.|.|.|.|.|,.|.|.|.|.|.|.|.|.|.|.|.|.|.|.|.|,.|.|.|.|.|.|.|.|.|.|.|.|.|.|.|.|,.|.|.|.|.|.|.|.|.|.|.|.|.|.|.|.|,.|.|.|.|.|.|.|.|.|.|.|.|.|.|.|.|,.|.|.|.|.|.|.|.|.|.|.|.|.|.|.|.|,.|.|.|.|.|.|.|.|.|.|.|.|.|.|.|.|,.|.|.|.|.|.|.|.|.|.|.|.|.|.|.|.|,.|.|.|.|.|.|.|.|.|.|.|.|.|.|.|.|,F|.|.|B|.|.|.|.|.|.|.|.|.|.|.|.|,F|.|.|.|.|.|.|1|C|.|.|.|.|.|.|.|,F|.|.|.|.|2|K|.|.|.|.|.|.|.|.|.|,F|.|.|.|.|.|.|1|C|.|.|.|.|.|.|.|,F|.|.|.|.|2|K|.|.|.|.|.|.|.|.|.|,F|.|.|.|.|.|.|1|C|.|.|.|.|.|.|.|,F|.|.|B|.|.|.|2|F|.|.|.|.|.|H|.|,.|.|.|B|.|.|.|.|.|.|.|.|.|.|.|.|,.|.|.|.|.|.|.|.|.|.|.|.|.|.|.|.|,.|.|.|.|.|.|.|.|.|.|.|.|.|.|.|.|,.|.|.|.|.|.|.|.|.|.|.|.|.|.|.|.|,.|.|.|.|.|.|.|.|.|.|.|.|.|.|.|.|,.|.|.|.|.|.|.|.|.|.|.|.|.|.|.|.|,.|.|.|.|.|.|.|.|.|.|.|.|.|.|.|.|,.|.|.|.|.|.|.|.|.|.|.|.|.|.|.|.|,.|.|.|.|.|.|.|.|.|.|.|.|.|.|.|.|,.|.|.|.|.|.|.|.|.|.|.|.|.|.|.|.|
.|.|.|.|.|.|.|.|.|.|.|.|.|.|.|.|,.|.|.|.|.|.|.|.|.|.|.|.|.|.|.|.|,.|.|.|.|.|.|.|.|.|.|.|.|.|.|.|.|,.|.|.|.|.|.|.|.|.|.|.|.|.|.|.|.|,.|.|.|.|.|.|.|.|.|.|.|.|.|.|.|.|,.|.|.|.|.|.|.|.|.|.|.|.|.|.|.|.|,.|.|.|.|.|.|.|.|.|.|.|.|.|.|.|.|,.|.|.|.|.|.|.|.|.|.|.|.|.|.|.|.|,.|.|.|.|.|.|.|.|.|.|.|.|.|.|.|.|,.|.|.|.|.|.|.|.|.|.|.|.|.|.|.|.|,.|.|.|.|.|.|.|.|.|.|.|.|.|.|.|.|,F|.|.|B|.|.|.|.|.|.|.|.|.|.|.|.|,.|B|.|B|.|.|.|.|.|.|.|.|.|.|.|.|,.|B|.|.|.|.|.|.|.|.|.|.|.|.|.|.|,.|B|.|.|.|.|.|.|.|.|.|.|.|.|.|.|,.|B|.|.|.|.|.|.|.|.|.|.|.|.|.|.|,.|B|.|.|.|.|.|.|.|.|.|.|.|.|.|.|,.|B|.|.|.|.|.|.|.|.|.|.|.|.|.|.|,.|.|.|.|.|.|.|.|.|.|.|.|.|.|.|.|,.|.|.|.|.|.|.|.|.|.|.|.|.|.|.|.|,.|.|.|.|.|.|.|.|.|.|.|.|.|.|.|.|,.|.|.|.|.|.|.|.|.|.|.|.|.|.|.|.|,.|.|.|.|.|.|.|.|.|.|.|.|.|.|.|.|,.|.|.|.|.|.|.|.|.|.|.|.|.|.|.|.|,.|.|.|.|.|.|.|.|.|.|.|.|.|.|.|.|,.|.|.|.|.|.|.|.|.|.|.|.|.|.|.|.|,.|.|.|.|.|.|.|.|.|.|.|.|.|.|.|.|,.|.|.|.|.|.|.|.|.|.|.|.|.|.|.|.|
.|.|.|.|.|.|.|.|.|.|.|.|.|.|.|.|,.|.|.|.|.|.|.|.|.|.|.|.|.|.|.|.|,.|.|.|.|.|.|.|.|.|.|.|.|.|.|.|.|,.|.|.|.|.|.|.|.|.|.|.|.|.|.|.|.|,.|.|.|.|.|.|.|.|.|.|.|.|.|.|.|.|,.|.|.|.|.|.|.|.|.|.|.|.|.|.|.|.|,.|.|.|.|.|.|.|.|.|.|.|.|.|.|.|.|,.|.|.|.|.|.|.|.|.|.|.|.|.|.|.|.|,.|.|.|.|.|.|.|.|.|.|.|.|.|.|.|.|,.|.|.|.|.|.|.|.|.|.|.|.|.|.|.|.|,.|.|.|.|.|.|.|.|.|.|.|.|.|.|.|.|,F|.|.|B|.|.|.|.|.|.|.|.|.|.|.|.|,.|.|.|B|.|.|.|.|.|.|.|.|.|.|.|.|,.|.|.|.|.|.|.|.|.|.|.|.|.|.|.|.|,.|.|.|.|.|.|.|.|.|.|.|.|.|.|.|.|,.|.|.|.|.|.|.|.|.|.|.|.|.|.|.|.|,.|.|.|.|.|.|.|.|.|.|.|.|.|.|.|.|,.|.|.|.|.|.|.|.|.|.|.|.|.|.|.|.|,.|.|.|.|.|.|.|.|.|.|.|.|.|.|.|.|,.|.|.|.|.|.|.|.|.|.|.|.|.|.|.|.|,.|.|.|.|.|.|.|.|.|.|.|.|.|.|.|.|,.|.|.|.|.|.|.|.|.|.|.|.|.|.|.|.|,.|.|.|.|.|.|.|.|.|.|.|.|.|.|.|.|,.|.|.|.|.|.|.|.|.|.|.|.|.|.|.|.|,.|.|.|.|.|.|.|.|.|.|.|.|.|.|.|.|,.|.|.|.|.|.|.|.|.|.|.|.|.|.|.|.|,.|.|.|.|.|.|.|.|.|.|.|.|.|.|.|.|,.|.|.|.|.|.|.|.|.|.|.|.|.|.|.|.|
.|.|.|.|.|.|.|.|.|.|.|.|.|.|.|.|,.|.|.|.|.|.|.|.|.|.|.|.|.|.|.|.|,.|.|.|.|.|.|.|.|.|.|.|.|.|.|.|.|,.|.|.|.|.|.|.|.|.|.|.|.|.|.|.|.|,.|.|.|.|.|.|.|.|.|.|.|.|.|.|.|.|,.|.|.|.|.|.|.|.|.|.|.|.|.|.|.|.|,.|.|.|.|.|.|.|.|.|.|.|.|.|.|.|.|,F|B|.|B|.|.|.|.|.|.|.|.|.|.|.|.|,F|B|.|.|.|.|.|.|.|.|.|.|.|.|.|.|,F|B|.|.|.|0|C|.|.|.|.|.|.|.|.|.|,F|B|.|.|.|.|.|.|.|.|.|.|.|.|.|.|,F|.|.|.|.|.|.|.|.|.|.|.|.|.|.|.|,F|B|.|.|.|0|C|.|.|.|.|.|.|.|.|.|,.|.|.|B|.|.|.|.|.|.|.|.|.|.|.|.|,.|.|.|.|.|.|.|.|.|.|.|.|.|.|.|.|,.|.|.|.|.|.|.|.|.|.|.|.|.|.|.|.|,.|.|.|.|.|.|.|.|.|.|.|.|.|.|.|.|,.|.|.|.|.|.|.|.|.|.|.|.|.|.|.|.|,.|.|.|.|.|.|.|.|.|.|.|.|.|.|.|.|,.|.|.|.|.|.|.|.|.|.|.|.|.|.|.|.|,.|.|.|.|.|.|.|.|.|.|.|.|.|.|.|.|,.|.|.|.|.|.|.|.|.|.|.|.|.|.|.|.|,.|.|.|.|.|.|.|.|.|.|.|.|.|.|.|.|,.|.|.|.|.|.|.|.|.|.|.|.|.|.|.|.|,.|.|.|.|.|.|.|.|.|.|.|.|.|.|.|.|,.|.|.|.|.|.|.|.|.|.|.|.|.|.|.|.|,.|.|.|.|.|.|.|.|.|.|.|.|.|.|.|.|,.|.|.|.|.|.|.|.|.|.|.|.|.|.|.|.|
.|.|.|.|.|.|.|.|.|.|.|.|.|.|.|.|,.|.|.|.|.|.|.|.|.|.|.|.|.|.|.|.|,.|.|.|.|.|.|.|.|.|.|.|.|.|.|.|.|,.|.|.|.|.|.|.|.|.|.|.|.|.|.|.|.|,.|.|.|.|.|.|.|.|.|.|.|.|.|.|.|.|,.|.|.|.|.|.|.|.|.|.|.|.|.|.|.|.|,.|.|.|.|.|.|.|.|.|.|.|.|.|.|.|.|,F|.|.|B|.|.|.|.|.|.|.|.|.|.|.|.|,F|.|.|.|.|.|.|.|.|.|.|.|.|.|.|.|,F|.|.|.|.|.|.|.|.|.|.|.|.|.|.|.|,F|.|.|.|.|2|B|.|.|.|.|.|.|.|.|.|,F|.|.|.|.|1|.|1|C|.|.|.|.|.|.|.|,F|.|.|.|.|.|T|.|.|.|.|.|.|.|.|.|,.|.|.|B|.|.|.|.|.|.|.|.|.|.|.|.|,.|.|.|.|.|.|.|.|.|.|.|.|.|.|.|.|,.|.|.|.|.|.|.|.|.|.|.|.|.|.|.|.|,.|.|.|.|.|.|.|.|.|.|.|.|.|.|.|.|,.|.|.|.|.|.|.|.|.|.|.|.|.|.|.|.|,.|.|.|.|.|.|.|.|.|.|.|.|.|.|.|.|,.|.|.|.|.|.|.|.|.|.|.|.|.|.|.|.|,.|.|.|.|.|.|.|.|.|.|.|.|.|.|.|.|,.|.|.|.|.|.|.|.|.|.|.|.|.|.|.|.|,.|.|.|.|.|.|.|.|.|.|.|.|.|.|.|.|,.|.|.|.|.|.|.|.|.|.|.|.|.|.|.|.|,.|.|.|.|.|.|.|.|.|.|.|.|.|.|.|.|,.|.|.|.|.|.|.|.|.|.|.|.|.|.|.|.|,.|.|.|.|.|.|.|.|.|.|.|.|.|.|.|.|,.|.|.|.|.|.|.|.|.|.|.|.|.|.|.|.|
.|.|.|.|.|.|.|.|.|.|.|.|.|.|.|.|,.|.|.|.|.|.|.|.|.|.|.|.|.|.|.|.|,.|.|.|.|.|.|.|.|.|.|.|.|.|.|.|.|,.|.|.|.|.|.|.|.|.|.|.|.|.|.|.|.|,.|.|.|.|.|.|.|.|.|.|.|.|.|.|.|.|,.|.|.|.|.|.|.|.|.|.|.|.|.|.|.|.|,.|.|.|.|.|.|.|.|.|.|.|.|.|.|.|.|,F|.|.|B|.|.|.|.|.|.|.|.|.|.|.|.|,F|.|.|.|.|1|.|1|C|.|.|.|.|.|.|.|,F|.|.|.|.|.|.|.|.|.|.|.|.|.|.|.|,F|.|.|.|.|2|B|.|.|.|.|.|.|.|.|.|,F|.|.|.|.|.|.|.|.|.|.|.|.|.|.|.|,F|.|.|.|.|.|.|.|.|.|.|.|.|.|.|.|,.|.|.|B|.|.|.|.|.|.|.|.|.|.|.|.|,.|.|.|.|.|.|.|.|.|.|.|.|.|.|.|.|,.|.|.|.|.|.|.|.|.|.|.|.|.|.|.|.|,.|.|.|.|.|.|.|.|.|.|.|.|.|.|.|.|,.|.|.|.|.|.|.|.|.|.|.|.|.|.|.|.|,.|.|.|.|.|.|.|.|.|.|.|.|.|.|.|.|,.|.|.|.|.|.|.|.|.|.|.|.|.|.|.|.|,.|.|.|.|.|.|.|.|.|.|.|.|.|.|.|.|,.|.|.|.|.|.|.|.|.|.|.|.|.|.|.|.|,.|.|.|.|.|.|.|.|.|.|.|.|.|.|.|.|,.|.|.|.|.|.|.|.|.|.|.|.|.|.|.|.|,.|.|.|.|.|.|.|.|.|.|.|.|.|.|.|.|,.|.|.|.|.|.|.|.|.|.|.|.|.|.|.|.|,.|.|.|.|.|.|.|.|.|.|.|.|.|.|.|.|,.|.|.|.|.|.|.|.|.|.|.|.|.|.|.|.|
.|.|.|.|.|.|.|.|.|.|.|.|.|.|.|.|,F|B|.|B|.|0|B|.|.|.|.|.|.|.|.|.|,F|B|.|W|D|.|.|.|.|.|.|.|.|3|P|.|,F|B|.|.|.|.|.|.|.|.|.|.|.|.|.|.|,F|B|.|.|.|.|.|.|.|.|.|.|2|.|.|.|,F|B|.|.|.|.|.|.|.|.|.|.|.|.|.|.|,F|B|.|.|.|.|.|.|.|.|.|.|.|.|.|.|,F|.|.|.|.|.|.|.|.|.|.|.|3|.|.|.|,F|.|.|.|.|.|.|.|.|.|.|.|.|.|.|.|,F|.|.|.|.|.|.|.|.|.|.|.|.|.|.|.|,F|.|.|.|.|2|B|.|.|.|.|.|.|.|.|.|,F|.|.|.|.|.|.|.|.|.|.|.|.|.|.|.|,F|.|.|.|.|.|.|1|D|.|.|.|.|.|.|.|,.|.|.|B|.|.|.|.|.|.|.|.|.|.|.|.|,.|.|.|.|.|.|.|.|.|.|.|.|.|.|.|.|,.|.|.|.|.|.|.|.|.|.|.|.|.|.|.|.|,.|.|.|.|.|.|.|.|.|.|.|.|.|.|.|.|,.|.|.|.|.|.|.|.|.|.|.|.|.|.|.|.|,.|.|.|.|.|.|.|.|.|.|.|.|.|.|.|.|,.|.|.|.|.|.|.|.|.|.|.|.|.|.|.|.|,.|.|.|.|.|.|.|.|.|.|.|.|.|.|.|.|,.|.|.|.|.|.|.|.|.|.|.|.|.|.|.|.|,.|.|.|.|.|.|.|.|.|.|.|.|.|.|.|.|,.|.|.|.|.|.|.|.|.|.|.|.|.|.|.|.|,.|.|.|.|.|.|.|.|.|.|.|.|.|.|.|.|,.|.|.|.|.|.|.|.|.|.|.|.|.|.|.|.|,.|.|.|.|.|.|.|.|.|.|.|.|.|.|.|.|,.|.|.|.|.|.|.|.|.|.|.|.|.|.|.|.|
.|.|.|.|.|.|.|.|.|.|.|.|.|.|.|.|,.|B|.|.|.|.|.|.|.|.|.|.|.|.|.|.|,.|B|.|.|.|.|.|.|.|.|.|.|.|.|.|.|,.|B|.|.|.|.|.|.|.|.|.|.|.|.|.|.|,F|.|.|B|.|.|.|.|.|.|.|.|.|.|.|.|,.|B|.|B|.|.|.|.|.|.|.|.|.|.|.|.|,.|B|.|.|.|.|.|.|.|.|.|.|.|.|.|.|,F|.|.|B|.|.|.|.|.|.|.|.|.|.|.|.|,F|.|.|.|.|1|.|1|C|.|.|.|.|.|.|.|,F|.|.|.|.|.|.|.|.|.|.|.|.|.|.|.|,F|.|.|.|.|2|B|.|.|.|.|.|.|.|.|.|,F|.|.|.|.|.|.|.|.|.|.|.|.|.|.|.|,F|.|.|.|.|.|.|.|.|.|.|.|.|.|.|.|,.|.|.|B|.|.|.|.|.|.|.|.|.|.|.|.|,.|.|.|.|.|.|.|.|.|.|.|.|.|.|.|.|,.|.|.|.|.|.|.|.|.|.|.|.|.|.|.|.|,.|.|.|.|.|.|.|.|.|.|.|.|.|.|.|.|,.|.|.|.|.|.|.|.|.|.|.|.|.|.|.|.|,.|.|.|.|.|.|.|.|.|.|.|.|.|.|.|.|,.|.|.|.|.|.|.|.|.|.|.|.|.|.|.|.|,.|.|.|.|.|.|.|.|.|.|.|.|.|.|.|.|,.|.|.|.|.|.|.|.|.|.|.|.|.|.|.|.|,.|.|.|.|.|.|.|.|.|.|.|.|.|.|.|.|,.|.|.|.|.|.|.|.|.|.|.|.|.|.|.|.|,.|.|.|.|.|.|.|.|.|.|.|.|.|.|.|.|,.|.|.|.|.|.|.|.|.|.|.|.|.|.|.|.|,.|.|.|.|.|.|.|.|.|.|.|.|.|.|.|.|,.|.|.|.|.|.|.|.|.|.|.|.|.|.|.|.|
.|.|.|.|.|.|.|.|.|.|.|.|.|.|.|.|,.|.|.|.|.|.|.|.|.|.|.|.|.|.|.|.|,F|B|.|B|.|.|.|.|.|.|.|.|.|.|.|.|,F|B|.|.|.|3|.|3|G|.|.|.|.|.|.|.|,F|.|.|.|.|.|.|.|.|.|.|.|.|.|.|.|,.|.|.|B|.|.|.|.|.|.|.|.|.|.|.|.|,.|.|.|.|.|.|.|.|.|.|.|.|.|.|.|.|,F|.|.|B|.|.|.|.|.|.|.|.|.|.|.|.|,F|.|.|.|.|.|.|.|.|.|.|.|.|.|.|.|,F|.|.|.|.|.|.|.|.|.|.|.|.|.|.|.|,F|.|.|.|.|2|B|.|.|.|.|.|.|.|.|.|,F|.|.|.|.|1|.|1|C|.|.|.|.|.|.|.|,F|.|.|.|.|.|T|.|.|.|.|.|.|.|.|.|,.|.|.|B|.|.|.|.|.|.|.|.|.|.|.|.|,.|.|.|.|.|.|.|.|.|.|.|.|.|.|.|.|,.|.|.|.|.|.|.|.|.|.|.|.|.|.|.|.|,.|.|.|.|.|.|.|.|.|.|.|.|.|.|.|.|,.|.|.|.|.|.|.|.|.|.|.|.|.|.|.|.|,.|.|.|.|.|.|.|.|.|.|.|.|.|.|.|.|,.|.|.|.|.|.|.|.|.|.|.|.|.|.|.|.|,.|.|.|.|.|.|.|.|.|.|.|.|.|.|.|.|,.|.|.|.|.|.|.|.|.|.|.|.|.|.|.|.|,.|.|.|.|.|.|.|.|.|.|.|.|.|.|.|.|,.|.|.|.|.|.|.|.|.|.|.|.|.|.|.|.|,.|.|.|.|.|.|.|.|.|.|.|.|.|.|.|.|,.|.|.|.|.|.|.|.|.|.|.|.|.|.|.|.|,.|.|.|.|.|.|.|.|.|.|.|.|.|.|.|.|,.|.|.|.|.|.|.|.|.|.|.|.|.|.|.|.|
.|.|.|.|.|.|.|.|.|.|.|.|.|.|.|.|,.|.|.|.|.|.|.|.|.|.|.|.|.|.|.|.|,F|.|.|B|.|.|.|.|.|.|.|.|.|.|.|.|,F|.|.|.|.|.|.|.|.|.|.|.|.|.|.|.|,F|.|.|.|.|2|.|2|G|.|.|.|.|.|.|.|,.|.|.|B|.|.|.|.|.|.|.|.|.|.|.|.|,.|.|.|.|.|.|.|.|.|.|.|.|.|.|.|.|,F|.|.|B|.|.|C|.|.|.|.|.|.|.|.|.|,F|.|.|.|.|.|.|.|.|.|.|.|.|.|.|.|,F|.|.|.|.|.|.|.|.|.|.|.|.|.|.|.|,F|.|.|.|.|2|B|.|.|.|.|.|.|.|.|.|,F|.|.|.|.|.|.|.|.|.|.|.|.|.|.|.|,F|.|.|.|.|2|C|.|.|.|.|.|.|.|.|.|,.|.|.|B|.|.|.|.|.|.|.|.|.|.|.|.|,.|.|.|.|.|.|.|.|.|.|.|.|.|.|.|.|,.|.|.|.|.|.|.|.|.|.|.|.|.|.|.|.|,.|.|.|.|.|.|.|.|.|.|.|.|.|.|.|.|,.|.|.|.|.|.|.|.|.|.|.|.|.|.|.|.|,.|.|.|.|.|.|.|.|.|.|.|.|.|.|.|.|,.|.|.|.|.|.|.|.|.|.|.|.|.|.|.|.|,.|.|.|.|.|.|.|.|.|.|.|.|.|.|.|.|,.|.|.|.|.|.|.|.|.|.|.|.|.|.|.|.|,.|.|.|.|.|.|.|.|.|.|.|.|.|.|.|.|,.|.|.|.|.|.|.|.|.|.|.|.|.|.|.|.|,.|.|.|.|.|.|.|.|.|.|.|.|.|.|.|.|,.|.|.|.|.|.|.|.|.|.|.|.|.|.|.|.|,.|.|.|.|.|.|.|.|.|.|.|.|.|.|.|.|,.|.|.|.|.|.|.|.|.|.|.|.|.|.|.|.|
.|.|.|.|.|.|.|.|.|.|.|.|.|.|.|.|,.|.|.|.|.|.|.|.|.|.|.|.|.|.|.|.|,.|B|.|.|.|.|.|.|.|.|.|.|.|.|.|.|,.|B|.|.|.|.|.|.|.|.|.|.|.|.|.|.|,.|B|.|.|.|.|.|.|.|.|.|.|.|.|.|.|,.|.|.|.|.|.|.|.|.|.|.|.|.|.|.|.|,.|.|.|.|.|.|.|.|.|.|.|.|.|.|.|.|,.|B|.|.|.|.|.|.|.|.|.|.|.|.|.|.|,.|B|.|.|.|.|.|.|.|.|.|.|.|.|.|.|,.|B|.|.|.|.|.|.|.|.|.|.|.|.|.|.|,.|B|.|.|.|.|.|.|.|.|.|.|.|.|.|.|,.|B|.|.|.|.|.|.|.|.|.|.|.|.|.|.|,.|B|.|.|.|.|.|.|.|.|.|.|.|.|.|.|,.|.|.|.|.|.|.|.|.|.|.|.|.|.|.|.|,.|.|.|.|.|.|.|.|.|.|.|.|.|.|.|.|,.|.|.|.|.|.|.|.|.|.|.|.|.|.|.|.|,.|.|.|.|.|.|.|.|.|.|.|.|.|.|.|.|,.|.|.|.|.|.|.|.|.|.|.|.|.|.|.|.|,.|.|.|.|.|.|.|.|.|.|.|.|.|.|.|.|,.|.|.|.|.|.|.|.|.|.|.|.|.|.|.|.|,.|.|.|.|.|.|.|.|.|.|.|.|.|.|.|.|,.|.|.|.|.|.|.|.|.|.|.|.|.|.|.|.|,.|.|.|.|.|.|.|.|.|.|.|.|.|.|.|.|,.|.|.|.|.|.|.|.|.|.|.|.|.|.|.|.|,.|.|.|.|.|.|.|.|.|.|.|.|.|.|.|.|,.|.|.|.|.|.|.|.|.|.|.|.|.|.|.|.|,.|.|.|.|.|.|.|.|.|.|.|.|.|.|.|.|,.|.|.|.|.|.|.|.|.|.|.|.|.|.|.|.|
.|.|.|.|.|.|.|.|.|.|.|.|.|.|.|.|,.|.|.|.|.|.|.|.|.|.|.|.|.|.|.|.|,.|.|.|.|.|.|.|.|.|.|.|.|.|.|.|.|,.|.|.|.|.|.|.|.|.|.|.|.|.|.|.|.|,.|.|.|.|.|.|.|.|.|.|.|.|.|.|.|.|,.|.|.|.|.|.|.|.|.|.|.|.|.|.|.|.|,.|.|.|.|.|.|.|.|.|.|.|.|.|.|.|.|,.|.|.|.|.|.|.|.|.|.|.|.|.|.|.|.|,.|.|.|.|.|.|.|.|.|.|.|.|.|.|.|.|,.|.|.|.|.|.|.|.|.|.|.|.|.|.|.|.|,.|.|.|.|.|.|.|.|.|.|.|.|.|.|.|.|,.|.|.|.|.|.|.|.|.|.|.|.|.|.|.|.|,.|.|.|.|.|.|.|.|.|.|.|.|.|.|.|.|,.|.|.|.|.|.|.|.|.|.|.|.|.|.|.|.|,.|.|.|.|.|.|.|.|.|.|.|.|.|.|.|.|,.|.|.|.|.|.|.|.|.|.|.|.|.|.|.|.|,.|.|.|.|.|.|.|.|.|.|.|.|.|.|.|.|,.|.|.|.|.|.|.|.|.|.|.|.|.|.|.|.|,.|.|.|.|.|.|.|.|.|.|.|.|.|.|.|.|,.|.|.|.|.|.|.|.|.|.|.|.|.|.|.|.|,.|.|.|.|.|.|.|.|.|.|.|.|.|.|.|.|,.|.|.|.|.|.|.|.|.|.|.|.|.|.|.|.|,.|.|.|.|.|.|.|.|.|.|.|.|.|.|.|.|,.|.|.|.|.|.|.|.|.|.|.|.|.|.|.|.|,.|.|.|.|.|.|.|.|.|.|.|.|.|.|.|.|,.|.|.|.|.|.|.|.|.|.|.|.|.|.|.|.|,.|.|.|.|.|.|.|.|.|.|.|.|.|.|.|.|,.|.|.|.|.|.|.|.|.|.|.|.|.|.|.|.|
.|.|.|.|.|.|.|.|.|.|.|.|.|.|.|.|,.|.|.|.|.|.|.|.|.|.|.|.|.|.|.|.|,.|.|.|.|.|.|.|.|.|.|.|.|.|.|.|.|,.|.|.|.|.|.|.|.|.|.|.|.|.|.|.|.|,.|.|.|.|.|.|.|.|.|.|.|.|.|.|.|.|,.|.|.|.|.|.|.|.|.|.|.|.|.|.|.|.|,.|.|.|.|.|.|.|.|.|.|.|.|.|.|.|.|,.|.|.|.|.|.|.|.|.|.|.|.|.|.|.|.|,.|.|.|.|.|.|.|.|.|.|.|.|.|.|.|.|,.|.|.|.|.|.|.|.|.|.|.|.|.|.|.|.|,.|.|.|.|.|.|.|.|.|.|.|.|.|.|.|.|,.|.|.|.|.|.|.|.|.|.|.|.|.|.|.|.|,.|.|.|.|.|.|.|.|.|.|.|.|.|.|.|.|,.|.|.|.|.|.|.|.|.|.|.|.|.|.|.|.|,.|.|.|.|.|.|.|.|.|.|.|.|.|.|.|.|,.|.|.|.|.|.|.|.|.|.|.|.|.|.|.|.|,.|.|.|.|.|.|.|.|.|.|.|.|.|.|.|.|,.|.|.|.|.|.|.|.|.|.|.|.|.|.|.|.|,.|.|.|.|.|.|.|.|.|.|.|.|.|.|.|.|,.|.|.|.|.|.|.|.|.|.|.|.|.|.|.|.|,.|.|.|.|.|.|.|.|.|.|.|.|.|.|.|.|,.|.|.|.|.|.|.|.|.|.|.|.|.|.|.|.|,.|.|.|.|.|.|.|.|.|.|.|.|.|.|.|.|,.|.|.|.|.|.|.|.|.|.|.|.|.|.|.|.|,.|.|.|.|.|.|.|.|.|.|.|.|.|.|.|.|,.|.|.|.|.|.|.|.|.|.|.|.|.|.|.|.|,.|.|.|.|.|.|.|.|.|.|.|.|.|.|.|.|,.|.|.|.|.|.|.|.|.|.|.|.|.|.|.|.|
.|.|.|.|.|.|.|.|.|.|.|.|.|.|.|.|,.|.|.|.|.|.|.|.|.|.|.|.|.|.|.|.|,.|.|.|.|.|.|.|.|.|.|.|.|.|.|.|.|,.|.|.|.|.|.|.|.|.|.|.|.|.|.|.|.|,.|.|.|.|.|.|.|.|.|.|.|.|.|.|.|.|,.|.|.|.|.|.|.|.|.|.|.|.|.|.|.|.|,.|.|.|.|.|.|.|.|.|.|.|.|.|.|.|.|,.|.|.|.|.|.|.|.|.|.|.|.|.|.|.|.|,.|.|.|.|.|.|.|.|.|.|.|.|.|.|.|.|,.|.|.|.|.|.|.|.|.|.|.|.|.|.|.|.|,.|.|.|.|.|.|.|.|.|.|.|.|.|.|.|.|,.|.|.|.|.|.|.|.|.|.|.|.|.|.|.|.|,.|.|.|.|.|.|.|.|.|.|.|.|.|.|.|.|,.|.|.|.|.|.|.|.|.|.|.|.|.|.|.|.|,.|.|.|.|.|.|.|.|.|.|.|.|.|.|.|.|,.|.|.|.|.|.|.|.|.|.|.|.|.|.|.|.|,.|.|.|.|.|.|.|.|.|.|.|.|.|.|.|.|,.|.|.|.|.|.|.|.|.|.|.|.|.|.|.|.|,.|.|.|.|.|.|.|.|.|.|.|.|.|.|.|.|,.|.|.|.|.|.|.|.|.|.|.|.|.|.|.|.|,.|.|.|.|.|.|.|.|.|.|.|.|.|.|.|.|,.|.|.|.|.|.|.|.|.|.|.|.|.|.|.|.|,.|.|.|.|.|.|.|.|.|.|.|.|.|.|.|.|,.|.|.|.|.|.|.|.|.|.|.|.|.|.|.|.|,.|.|.|.|.|.|.|.|.|.|.|.|.|.|.|.|,.|.|.|.|.|.|.|.|.|.|.|.|.|.|.|.|,.|.|.|.|.|.|.|.|.|.|.|.|.|.|.|.|,.|.|.|.|.|.|.|.|.|.|.|.|.|.|.|.|
.|.|.|.|.|.|.|.|.|.|.|.|.|.|.|.|,.|.|.|.|.|.|.|.|.|.|.|.|.|.|.|.|,.|.|.|.|.|.|.|.|.|.|.|.|.|.|.|.|,.|.|.|.|.|.|.|.|.|.|.|.|.|.|.|.|,.|.|.|.|.|.|.|.|.|.|.|.|.|.|.|.|,.|.|.|.|.|.|.|.|.|.|.|.|.|.|.|.|,.|.|.|.|.|.|.|.|.|.|.|.|.|.|.|.|,.|.|.|.|.|.|.|.|.|.|.|.|.|.|.|.|,.|.|.|.|.|.|.|.|.|.|.|.|.|.|.|.|,.|.|.|.|.|.|.|.|.|.|.|.|.|.|.|.|,.|.|.|.|.|.|.|.|.|.|.|.|.|.|.|.|,.|.|.|.|.|.|.|.|.|.|.|.|.|.|.|.|,.|.|.|.|.|.|.|.|.|.|.|.|.|.|.|.|,.|.|.|.|.|.|.|.|.|.|.|.|.|.|.|.|,.|.|.|.|.|.|.|.|.|.|.|.|.|.|.|.|,.|.|.|.|.|.|.|.|.|.|.|.|.|.|.|.|,.|.|.|.|.|.|.|.|.|.|.|.|.|.|.|.|,.|.|.|.|.|.|.|.|.|.|.|.|.|.|.|.|,.|.|.|.|.|.|.|.|.|.|.|.|.|.|.|.|,.|.|.|.|.|.|.|.|.|.|.|.|.|.|.|.|,.|.|.|.|.|.|.|.|.|.|.|.|.|.|.|.|,.|.|.|.|.|.|.|.|.|.|.|.|.|.|.|.|,.|.|.|.|.|.|.|.|.|.|.|.|.|.|.|.|,.|.|.|.|.|.|.|.|.|.|.|.|.|.|.|.|,.|.|.|.|.|.|.|.|.|.|.|.|.|.|.|.|,.|.|.|.|.|.|.|.|.|.|.|.|.|.|.|.|,.|.|.|.|.|.|.|.|.|.|.|.|.|.|.|.|,.|.|.|.|.|.|.|.|.|.|.|.|.|.|.|.|
.|.|.|.|.|.|.|.|.|.|.|.|.|.|.|.|,.|.|.|.|.|.|.|.|.|.|.|.|.|.|.|.|,.|.|.|.|.|.|.|.|.|.|.|.|.|.|.|.|,.|.|.|.|.|.|.|.|.|.|.|.|.|.|.|.|,.|.|.|.|.|.|.|.|.|.|.|.|.|.|.|.|,.|.|.|.|.|.|.|.|.|.|.|.|.|.|.|.|,.|.|.|.|.|.|.|.|.|.|.|.|.|.|.|.|,.|.|.|.|.|.|.|.|.|.|.|.|.|.|.|.|,.|.|.|.|.|.|.|.|.|.|.|.|.|.|.|.|,.|.|.|.|.|.|.|.|.|.|.|.|.|.|.|.|,.|.|.|.|.|.|.|.|.|.|.|.|.|.|.|.|,.|.|.|.|.|.|.|.|.|.|.|.|.|.|.|.|,.|.|.|.|.|.|.|.|.|.|.|.|.|.|.|.|,.|.|.|.|.|.|.|.|.|.|.|.|.|.|.|.|,.|.|.|.|.|.|.|.|.|.|.|.|.|.|.|.|,.|.|.|.|.|.|.|.|.|.|.|.|.|.|.|.|,.|.|.|.|.|.|.|.|.|.|.|.|.|.|.|.|,.|.|.|.|.|.|.|.|.|.|.|.|.|.|.|.|,.|.|.|.|.|.|.|.|.|.|.|.|.|.|.|.|,.|.|.|.|.|.|.|.|.|.|.|.|.|.|.|.|,.|.|.|.|.|.|.|.|.|.|.|.|.|.|.|.|,.|.|.|.|.|.|.|.|.|.|.|.|.|.|.|.|,.|.|.|.|.|.|.|.|.|.|.|.|.|.|.|.|,.|.|.|.|.|.|.|.|.|.|.|.|.|.|.|.|,.|.|.|.|.|.|.|.|.|.|.|.|.|.|.|.|,.|.|.|.|.|.|.|.|.|.|.|.|.|.|.|.|,.|.|.|.|.|.|.|.|.|.|.|.|.|.|.|.|,.|.|.|.|.|.|.|.|.|.|.|.|.|.|.|.|
.|.|.|.|.|.|.|.|.|.|.|.|.|.|.|.|,.|.|.|.|.|.|.|.|.|.|.|.|.|.|.|.|,.|.|.|.|.|.|.|.|.|.|.|.|.|.|.|.|,.|.|.|.|.|.|.|.|.|.|.|.|.|.|.|.|,.|.|.|.|.|.|.|.|.|.|.|.|.|.|.|.|,.|.|.|.|.|.|.|.|.|.|.|.|.|.|.|.|,.|.|.|.|.|.|.|.|.|.|.|.|.|.|.|.|,.|.|.|.|.|.|.|.|.|.|.|.|.|.|.|.|,.|.|.|.|.|.|.|.|.|.|.|.|.|.|.|.|,.|.|.|.|.|.|.|.|.|.|.|.|.|.|.|.|,.|.|.|.|.|.|.|.|.|.|.|.|.|.|.|.|,.|.|.|.|.|.|.|.|.|.|.|.|.|.|.|.|,.|.|.|.|.|.|.|.|.|.|.|.|.|.|.|.|,.|.|.|.|.|.|.|.|.|.|.|.|.|.|.|.|,.|.|.|.|.|.|.|.|.|.|.|.|.|.|.|.|,.|.|.|.|.|.|.|.|.|.|.|.|.|.|.|.|,.|.|.|.|.|.|.|.|.|.|.|.|.|.|.|.|,.|.|.|.|.|.|.|.|.|.|.|.|.|.|.|.|,.|.|.|.|.|.|.|.|.|.|.|.|.|.|.|.|,.|.|.|.|.|.|.|.|.|.|.|.|.|.|.|.|,.|.|.|.|.|.|.|.|.|.|.|.|.|.|.|.|,.|.|.|.|.|.|.|.|.|.|.|.|.|.|.|.|,.|.|.|.|.|.|.|.|.|.|.|.|.|.|.|.|,.|.|.|.|.|.|.|.|.|.|.|.|.|.|.|.|,.|.|.|.|.|.|.|.|.|.|.|.|.|.|.|.|,.|.|.|.|.|.|.|.|.|.|.|.|.|.|.|.|,.|.|.|.|.|.|.|.|.|.|.|.|.|.|.|.|,.|.|.|.|.|.|.|.|.|.|.|.|.|.|.|.|
.|.|.|.|.|.|.|.|.|.|.|.|.|.|.|.|,.|.|.|.|.|.|.|.|.|.|.|.|.|.|.|.|,.|.|.|.|.|.|.|.|.|.|.|.|.|.|.|.|,.|.|.|.|.|.|.|.|.|.|.|.|.|.|.|.|,.|.|.|.|.|.|.|.|.|.|.|.|.|.|.|.|,.|.|.|.|.|.|.|.|.|.|.|.|.|.|.|.|,.|.|.|.|.|.|.|.|.|.|.|.|.|.|.|.|,.|.|.|.|.|.|.|.|.|.|.|.|.|.|.|.|,.|.|.|.|.|.|.|.|.|.|.|.|.|.|.|.|,.|.|.|.|.|.|.|.|.|.|.|.|.|.|.|.|,.|.|.|.|.|.|.|.|.|.|.|.|.|.|.|.|,.|.|.|.|.|.|.|.|.|.|.|.|.|.|.|.|,.|.|.|.|.|.|.|.|.|.|.|.|.|.|.|.|,.|.|.|.|.|.|.|.|.|.|.|.|.|.|.|.|,.|.|.|.|.|.|.|.|.|.|.|.|.|.|.|.|,.|.|.|.|.|.|.|.|.|.|.|.|.|.|.|.|,.|.|.|.|.|.|.|.|.|.|.|.|.|.|.|.|,.|.|.|.|.|.|.|.|.|.|.|.|.|.|.|.|,.|.|.|.|.|.|.|.|.|.|.|.|.|.|.|.|,.|.|.|.|.|.|.|.|.|.|.|.|.|.|.|.|,.|.|.|.|.|.|.|.|.|.|.|.|.|.|.|.|,.|.|.|.|.|.|.|.|.|.|.|.|.|.|.|.|,.|.|.|.|.|.|.|.|.|.|.|.|.|.|.|.|,.|.|.|.|.|.|.|.|.|.|.|.|.|.|.|.|,.|.|.|.|.|.|.|.|.|.|.|.|.|.|.|.|,.|.|.|.|.|.|.|.|.|.|.|.|.|.|.|.|,.|.|.|.|.|.|.|.|.|.|.|.|.|.|.|.|,.|.|.|.|.|.|.|.|.|.|.|.|.|.|.|.|
.|.|.|.|.|.|.|.|.|.|.|.|.|.|.|.|,.|.|.|.|.|.|.|.|.|.|.|.|.|.|.|.|,.|.|.|.|.|.|.|.|.|.|.|.|.|.|.|.|,.|.|.|.|.|.|.|.|.|.|.|.|.|.|.|.|,.|.|.|.|.|.|.|.|.|.|.|.|.|.|.|.|,.|.|.|.|.|.|.|.|.|.|.|.|.|.|.|.|,.|.|.|.|.|.|.|.|.|.|.|.|.|.|.|.|,.|.|.|.|.|.|.|.|.|.|.|.|.|.|.|.|,.|.|.|.|.|.|.|.|.|.|.|.|.|.|.|.|,.|.|.|.|.|.|.|.|.|.|.|.|.|.|.|.|,.|.|.|.|.|.|.|.|.|.|.|.|.|.|.|.|,.|.|.|.|.|.|.|.|.|.|.|.|.|.|.|.|,.|.|.|.|.|.|.|.|.|.|.|.|.|.|.|.|,.|.|.|.|.|.|.|.|.|.|.|.|.|.|.|.|,.|.|.|.|.|.|.|.|.|.|.|.|.|.|.|.|,.|.|.|.|.|.|.|.|.|.|.|.|.|.|.|.|,.|.|.|.|.|.|.|.|.|.|.|.|.|.|.|.|,.|.|.|.|.|.|.|.|.|.|.|.|.|.|.|.|,.|.|.|.|.|.|.|.|.|.|.|.|.|.|.|.|,.|.|.|.|.|.|.|.|.|.|.|.|.|.|.|.|,.|.|.|.|.|.|.|.|.|.|.|.|.|.|.|.|,.|.|.|.|.|.|.|.|.|.|.|.|.|.|.|.|,.|.|.|.|.|.|.|.|.|.|.|.|.|.|.|.|,.|.|.|.|.|.|.|.|.|.|.|.|.|.|.|.|,.|.|.|.|.|.|.|.|.|.|.|.|.|.|.|.|,.|.|.|.|.|.|.|.|.|.|.|.|.|.|.|.|,.|.|.|.|.|.|.|.|.|.|.|.|.|.|.|.|,.|.|.|.|.|.|.|.|.|.|.|.|.|.|.|.|
.|.|.|.|.|.|.|.|.|.|.|.|.|.|.|.|,.|.|.|.|.|.|.|.|.|.|.|.|.|.|.|.|,.|.|.|.|.|.|.|.|.|.|.|.|.|.|.|.|,.|.|.|.|.|.|.|.|.|.|.|.|.|.|.|.|,.|.|.|.|.|.|.|.|.|.|.|.|.|.|.|.|,.|.|.|.|.|.|.|.|.|.|.|.|.|.|.|.|,.|.|.|.|.|.|.|.|.|.|.|.|.|.|.|.|,.|.|.|.|.|.|.|.|.|.|.|.|.|.|.|.|,.|.|.|.|.|.|.|.|.|.|.|.|.|.|.|.|,.|.|.|.|.|.|.|.|.|.|.|.|.|.|.|.|,.|.|.|.|.|.|.|.|.|.|.|.|.|.|.|.|,.|.|.|.|.|.|.|.|.|.|.|.|.|.|.|.|,.|.|.|.|.|.|.|.|.|.|.|.|.|.|.|.|,.|.|.|.|.|.|.|.|.|.|.|.|.|.|.|.|,.|.|.|.|.|.|.|.|.|.|.|.|.|.|.|.|,.|.|.|.|.|.|.|.|.|.|.|.|.|.|.|.|,.|.|.|.|.|.|.|.|.|.|.|.|.|.|.|.|,.|.|.|.|.|.|.|.|.|.|.|.|.|.|.|.|,.|.|.|.|.|.|.|.|.|.|.|.|.|.|.|.|,.|.|.|.|.|.|.|.|.|.|.|.|.|.|.|.|,.|.|.|.|.|.|.|.|.|.|.|.|.|.|.|.|,.|.|.|.|.|.|.|.|.|.|.|.|.|.|.|.|,.|.|.|.|.|.|.|.|.|.|.|.|.|.|.|.|,.|.|.|.|.|.|.|.|.|.|.|.|.|.|.|.|,.|.|.|.|.|.|.|.|.|.|.|.|.|.|.|.|,.|.|.|.|.|.|.|.|.|.|.|.|.|.|.|.|,.|.|.|.|.|.|.|.|.|.|.|.|.|.|.|.|,.|.|.|.|.|.|.|.|.|.|.|.|.|.|.|.|
.|.|.|.|.|.|.|.|.|.|.|.|.|.|.|.|,.|.|.|.|.|.|.|.|.|.|.|.|.|.|.|.|,.|.|.|.|.|.|.|.|.|.|.|.|.|.|.|.|,.|.|.|.|.|.|.|.|.|.|.|.|.|.|.|.|,.|.|.|.|.|.|.|.|.|.|.|.|.|.|.|.|,.|.|.|.|.|.|.|.|.|.|.|.|.|.|.|.|,.|.|.|.|.|.|.|.|.|.|.|.|.|.|.|.|,.|.|.|.|.|.|.|.|.|.|.|.|.|.|.|.|,.|.|.|.|.|.|.|.|.|.|.|.|.|.|.|.|,.|.|.|.|.|.|.|.|.|.|.|.|.|.|.|.|,.|.|.|.|.|.|.|.|.|.|.|.|.|.|.|.|,.|.|.|.|.|.|.|.|.|.|.|.|.|.|.|.|,.|.|.|.|.|.|.|.|.|.|.|.|.|.|.|.|,.|.|.|.|.|.|.|.|.|.|.|.|.|.|.|.|,.|.|.|.|.|.|.|.|.|.|.|.|.|.|.|.|,.|.|.|.|.|.|.|.|.|.|.|.|.|.|.|.|,.|.|.|.|.|.|.|.|.|.|.|.|.|.|.|.|,.|.|.|.|.|.|.|.|.|.|.|.|.|.|.|.|,.|.|.|.|.|.|.|.|.|.|.|.|.|.|.|.|,.|.|.|.|.|.|.|.|.|.|.|.|.|.|.|.|,.|.|.|.|.|.|.|.|.|.|.|.|.|.|.|.|,.|.|.|.|.|.|.|.|.|.|.|.|.|.|.|.|,.|.|.|.|.|.|.|.|.|.|.|.|.|.|.|.|,.|.|.|.|.|.|.|.|.|.|.|.|.|.|.|.|,.|.|.|.|.|.|.|.|.|.|.|.|.|.|.|.|,.|.|.|.|.|.|.|.|.|.|.|.|.|.|.|.|,.|.|.|.|.|.|.|.|.|.|.|.|.|.|.|.|,.|.|.|.|.|.|.|.|.|.|.|.|.|.|.|.|
