.|.|.|.|.|.|.|.|.|.|.|.|.|.|.|.|,.|.|.|.|.|.|.|.|.|.|.|.|.|.|.|.|,.|.|.|.|.|.|.|.|.|.|.|.|.|.|.|.|,.|.|.|.|.|.|.|.|.|.|.|.|.|.|.|.|,.|.|.|.|.|.|.|.|.|.|.|.|.|.|.|.|,.|.|.|.|.|.|.|.|.|.|.|.|.|.|.|.|,.|.|.|.|.|.|.|.|.|.|.|.|.|.|.|.|,.|.|.|.|.|.|.|.|.|.|.|.|.|.|.|.|,.|.|.|.|.|.|.|.|.|.|.|.|.|.|.|.|,.|.|.|.|.|.|.|.|.|.|.|.|.|.|.|.|,.|.|.|.|.|.|.|.|.|.|.|.|.|.|.|.|,.|.|.|.|.|.|.|.|.|.|.|.|.|.|.|.|,.|.|.|.|.|.|.|.|.|.|.|.|.|.|.|.|,.|.|.|.|.|.|.|.|.|.|.|.|.|.|.|.|,.|.|.|.|.|.|.|.|.|.|.|.|.|.|.|.|,.|.|.|.|.|.|.|.|.|.|.|.|.|.|.|.|,.|.|.|.|.|.|.|.|.|.|.|.|.|.|.|.|,.|.|.|.|.|.|.|.|.|.|.|.|.|.|.|.|,.|.|.|.|.|.|.|.|.|.|.|.|.|.|.|.|,.|.|.|.|.|.|.|.|.|.|.|.|.|.|.|.|,.|.|.|.|.|.|.|.|.|.|.|.|.|.|.|.|,.|.|.|.|.|.|.|.|.|.|.|.|.|.|.|.|,.|.|.|.|.|.|.|.|.|.|.|.|.|.|.|.|,.|.|.|.|.|.|.|.|.|.|.|.|.|.|.|.|,.|.|.|.|.|.|.|.|.|.|.|.|.|.|.|.|,.|.|.|.|.|.|.|.|.|.|.|.|.|.|.|.|,.|.|.|.|.|.|.|.|.|.|.|.|.|.|.|.|,.|.|.|.|.|.|.|.|.|.|.|.|.|.|.|.|
.|.|.|.|.|.|.|.|.|.|.|.|.|.|.|.|,.|.|.|.|.|.|.|.|.|.|.|.|.|.|.|.|,.|.|.|.|.|.|.|.|.|.|.|.|.|.|.|.|,.|.|.|.|.|.|.|.|.|.|.|.|.|.|.|.|,.|.|.|.|.|.|.|.|.|.|.|.|.|.|.|.|,.|.|.|.|.|.|.|.|.|.|.|.|.|.|.|.|,.|.|.|.|.|.|.|.|.|.|.|.|.|.|.|.|,.|.|.|.|.|.|.|.|.|.|.|.|.|.|.|.|,.|.|.|.|.|.|.|.|.|.|.|.|.|.|.|.|,.|.|.|.|.|.|.|.|.|.|.|.|.|.|.|.|,.|.|.|.|.|.|.|.|.|.|.|.|.|.|.|.|,.|.|.|.|.|.|.|.|.|.|.|.|.|.|.|.|,.|.|.|.|.|.|.|.|.|.|.|.|.|.|.|.|,.|.|.|.|.|.|.|.|.|.|.|.|.|.|.|.|,.|.|.|.|.|.|.|.|.|.|.|.|.|.|.|.|,.|.|.|.|.|.|.|.|.|.|.|.|.|.|.|.|,.|.|.|.|.|.|.|.|.|.|.|.|.|.|.|.|,.|.|.|.|.|.|.|.|.|.|.|.|.|.|.|.|,.|.|.|.|.|.|.|.|.|.|.|.|.|.|.|.|,.|.|.|.|.|.|.|.|.|.|.|.|.|.|.|.|,F|C|.|C|.|.|.|3|C|.|.|.|.|.|.|.|,F|C|.|.|.|.|.|.|.|.|.|.|2|.|.|.|,F|C|.|.|.|.|.|.|.|.|.|.|.|1|P|.|,F|C|.|.|.|2|B|.|.|.|.|.|.|.|.|.|,e|.|.|.|.|.|.|.|.|.|.|.|.|.|.|.|,.|.|.|.|.|.|.|.|.|.|.|.|.|.|.|.|,.|.|.|.|.|.|.|.|.|.|.|.|.|.|.|.|,.|.|.|.|.|.|.|.|.|.|.|.|.|.|.|.|
.|.|.|.|.|.|.|.|.|.|.|.|.|.|.|.|,.|.|.|.|.|.|.|.|.|.|.|.|.|.|.|.|,.|.|.|.|.|.|.|.|.|.|.|.|.|.|.|.|,.|.|.|.|.|.|.|.|.|.|.|.|.|.|.|.|,.|.|.|.|.|.|.|.|.|.|.|.|.|.|.|.|,.|.|.|.|.|.|.|.|.|.|.|.|.|.|.|.|,.|.|.|.|.|.|.|.|.|.|.|.|.|.|.|.|,.|.|.|.|.|.|.|.|.|.|.|.|.|.|.|.|,.|.|.|.|.|.|.|.|.|.|.|.|.|.|.|.|,.|.|.|.|.|.|.|.|.|.|.|.|.|.|.|.|,.|.|.|.|.|.|.|.|.|.|.|.|.|.|.|.|,.|.|.|.|.|.|.|.|.|.|.|.|.|.|.|.|,.|.|.|.|.|.|.|.|.|.|.|.|.|.|.|.|,.|.|.|.|.|.|.|.|.|.|.|.|.|.|.|.|,.|.|.|.|.|.|.|.|.|.|.|.|.|.|.|.|,.|.|.|.|.|.|.|.|.|.|.|.|.|.|.|.|,.|.|.|.|.|.|.|.|.|.|.|.|.|.|.|.|,.|.|.|.|.|.|.|.|.|.|.|.|.|.|.|.|,.|.|.|.|.|.|.|.|.|.|.|.|.|.|.|.|,.|.|.|.|.|.|.|.|.|.|.|.|.|.|.|.|,F|.|.|C|.|.|.|2|C|.|.|.|.|.|.|.|,.|C|.|C|.|.|.|.|.|.|.|.|.|.|.|.|,.|C|.|.|.|.|.|.|.|.|.|.|.|.|.|.|,.|C|.|.|.|.|.|.|.|.|.|.|.|.|.|.|,.|.|.|.|.|.|.|.|.|.|.|.|.|.|.|.|,.|.|.|.|.|.|.|.|.|.|.|.|.|.|.|.|,.|.|.|.|.|.|.|.|.|.|.|.|.|.|.|.|,.|.|.|.|.|.|.|.|.|.|.|.|.|.|.|.|
.|.|.|.|.|.|.|.|.|.|.|.|.|.|.|.|,.|.|.|.|.|.|.|.|.|.|.|.|.|.|.|.|,.|.|.|.|.|.|.|.|.|.|.|.|.|.|.|.|,.|.|.|.|.|.|.|.|.|.|.|.|.|.|.|.|,.|.|.|.|.|.|.|.|.|.|.|.|.|.|.|.|,.|.|.|.|.|.|.|.|.|.|.|.|.|.|.|.|,.|.|.|.|.|.|.|.|.|.|.|.|.|.|.|.|,.|.|.|.|.|.|.|.|.|.|.|.|.|.|.|.|,.|.|.|.|.|.|.|.|.|.|.|.|.|.|.|.|,.|.|.|.|.|.|.|.|.|.|.|.|.|.|.|.|,F|C|.|C|.|.|.|.|.|.|.|.|.|.|.|.|,F|C|.|C|.|.|.|0|H|.|.|.|.|.|.|.|,F|C|.|.|.|.|.|.|.|.|H|.|.|.|.|.|,.|.|.|C|.|.|.|.|.|.|.|.|.|.|.|.|,.|.|.|.|.|.|.|.|.|.|.|.|.|.|.|.|,.|.|.|.|.|.|.|.|.|.|.|.|.|.|.|.|,.|.|.|.|.|.|.|.|.|.|.|.|.|.|.|.|,.|.|.|.|.|.|.|.|.|.|.|.|.|.|.|.|,F|C|.|C|.|.|D|.|.|.|.|.|.|.|.|.|,F|C|.|.|.|1|L|0|.|.|.|.|.|.|.|.|,F|.|.|C|.|.|.|.|.|.|.|.|.|.|.|.|,.|.|.|C|.|.|.|.|.|.|.|.|.|.|.|.|,.|.|.|.|.|.|.|.|.|.|.|.|.|.|.|.|,.|.|.|.|.|.|.|.|.|.|.|.|.|.|.|.|,.|.|.|.|.|.|.|.|.|.|.|.|.|.|.|.|,.|.|.|.|.|.|.|.|.|.|.|.|.|.|.|.|,.|.|.|.|.|.|.|.|.|.|.|.|.|.|.|.|,.|.|.|.|.|.|.|.|.|.|.|.|.|.|.|.|
.|.|.|.|.|.|.|.|.|.|.|.|.|.|.|.|,.|.|.|.|.|.|.|.|.|.|.|.|.|.|.|.|,.|.|.|.|.|.|.|.|.|.|.|.|.|.|.|.|,.|.|.|.|.|.|.|.|.|.|.|.|.|.|.|.|,.|.|.|.|.|.|.|.|.|.|.|.|.|.|.|.|,.|.|.|.|.|.|.|.|.|.|.|.|.|.|.|.|,.|.|.|.|.|.|.|.|.|.|.|.|.|.|.|.|,.|.|.|.|.|.|.|.|.|.|.|.|.|.|.|.|,.|.|.|.|.|.|.|.|.|.|.|.|.|.|.|.|,.|.|.|.|.|.|.|.|.|.|.|.|.|.|.|.|,F|.|.|C|.|.|.|.|.|.|.|.|.|.|.|.|,F|.|.|C|D|.|.|.|.|.|.|.|.|.|.|.|,F|.|.|.|.|.|.|.|.|.|.|.|.|.|.|.|,.|.|.|C|.|.|.|.|.|.|.|.|.|.|.|.|,.|.|.|.|.|.|.|.|.|.|.|.|.|.|.|.|,.|.|.|.|.|.|.|.|.|.|.|.|.|.|.|.|,.|.|.|.|.|.|.|.|.|.|.|.|.|.|.|.|,.|.|.|.|.|.|.|.|.|.|.|.|.|.|.|.|,F|.|.|C|.|.|.|.|.|.|C|.|.|.|.|.|,F|.|.|.|.|.|.|.|.|.|.|.|.|.|.|.|,F|.|.|C|D|.|.|.|.|.|.|.|.|.|.|.|,.|.|.|C|.|.|.|.|.|.|.|.|.|.|.|.|,.|.|.|.|.|.|.|.|.|.|.|.|.|.|.|.|,.|.|.|.|.|.|.|.|.|.|.|.|.|.|.|.|,.|.|.|.|.|.|.|.|.|.|.|.|.|.|.|.|,.|.|.|.|.|.|.|.|.|.|.|.|.|.|.|.|,.|.|.|.|.|.|.|.|.|.|.|.|.|.|.|.|,.|.|.|.|.|.|.|.|.|.|.|.|.|.|.|.|
.|.|.|.|.|.|.|.|.|.|.|.|.|.|.|.|,.|.|.|.|.|.|.|.|.|.|.|.|.|.|.|.|,.|.|.|.|.|.|.|.|.|.|.|.|.|.|.|.|,.|.|.|.|.|.|.|.|.|.|.|.|.|.|.|.|,.|.|.|.|.|.|.|.|.|.|.|.|.|.|.|.|,.|.|.|.|.|.|.|.|.|.|.|.|.|.|.|.|,.|.|.|.|.|.|.|.|.|.|.|.|.|.|.|.|,.|.|.|.|.|.|.|.|.|.|.|.|.|.|.|.|,.|.|.|.|.|.|.|.|.|.|.|.|.|.|.|.|,.|.|.|.|.|.|.|.|.|.|.|.|.|.|.|.|,F|.|.|C|.|.|.|.|.|.|.|.|.|.|.|.|,F|.|.|C|.|.|.|2|H|.|.|.|.|.|.|.|,F|.|.|.|.|.|.|.|.|.|.|.|.|.|.|.|,.|.|.|C|.|.|.|.|.|.|.|.|.|.|.|.|,.|.|.|.|.|.|.|.|.|.|.|.|.|.|.|.|,.|.|.|.|.|.|.|.|.|.|.|.|.|.|.|.|,.|.|.|.|.|.|.|.|.|.|.|.|.|.|.|.|,.|.|.|.|.|.|.|.|.|.|.|.|.|.|.|.|,.|C|.|.|.|.|.|.|.|.|.|.|.|.|.|.|,.|C|.|.|.|.|.|.|.|.|.|.|.|.|.|.|,F|.|.|C|.|.|.|.|.|.|.|.|.|.|.|.|,.|.|.|C|.|.|.|.|.|.|.|.|.|.|.|.|,.|.|.|.|.|.|.|.|.|.|.|.|.|.|.|.|,.|.|.|.|.|.|.|.|.|.|.|.|.|.|.|.|,.|.|.|.|.|.|.|.|.|.|.|.|.|.|.|.|,.|.|.|.|.|.|.|.|.|.|.|.|.|.|.|.|,.|.|.|.|.|.|.|.|.|.|.|.|.|.|.|.|,.|.|.|.|.|.|.|.|.|.|.|.|.|.|.|.|
.|.|.|.|.|.|.|.|.|.|.|.|.|.|.|.|,.|.|.|.|.|.|.|.|.|.|.|.|.|.|.|.|,.|.|.|.|.|.|.|.|.|.|.|.|.|.|.|.|,.|.|.|.|.|.|.|.|.|.|.|.|.|.|.|.|,.|.|.|.|.|.|.|.|.|.|.|.|.|.|.|.|,.|.|.|.|.|.|.|.|.|.|.|.|.|.|.|.|,.|.|.|.|.|.|.|.|.|.|.|.|.|.|.|.|,.|.|.|.|.|.|.|.|.|.|.|.|.|.|.|.|,.|.|.|.|.|.|.|.|.|.|.|.|.|.|.|.|,.|.|.|.|.|.|.|.|.|.|.|.|.|.|.|.|,F|.|.|C|.|.|.|.|.|.|.|.|.|.|.|.|,F|.|.|C|.|.|.|.|.|.|.|.|.|.|.|.|,F|.|.|.|.|.|.|.|.|.|E|.|.|.|.|.|,.|.|.|C|.|.|.|.|.|.|.|.|.|.|.|.|,.|.|.|.|.|.|.|.|.|.|.|.|.|.|.|.|,.|.|.|.|.|.|.|.|.|.|.|.|.|.|.|.|,.|.|.|.|.|.|.|.|.|.|.|.|.|.|.|.|,.|.|.|.|.|.|.|.|.|.|.|.|.|.|.|.|,.|.|.|.|.|.|.|.|.|.|.|.|.|.|.|.|,.|.|.|.|.|.|.|.|.|.|.|.|.|.|.|.|,F|.|.|C|.|.|.|.|.|.|.|.|.|.|.|.|,F|C|.|C|D|.|.|.|.|.|.|.|.|.|.|.|,F|C|.|.|.|.|D|.|.|.|.|.|.|.|.|.|,.|.|.|C|.|.|.|.|.|.|.|.|.|.|.|.|,.|.|.|.|.|.|.|.|.|.|.|.|.|.|.|.|,.|.|.|.|.|.|.|.|.|.|.|.|.|.|.|.|,.|.|.|.|.|.|.|.|.|.|.|.|.|.|.|.|,.|.|.|.|.|.|.|.|.|.|.|.|.|.|.|.|
.|.|.|.|.|.|.|.|.|.|.|.|.|.|.|.|,.|.|.|.|.|.|.|.|.|.|.|.|.|.|.|.|,.|.|.|.|.|.|.|.|.|.|.|.|.|.|.|.|,.|.|.|.|.|.|.|.|.|.|.|.|.|.|.|.|,.|.|.|.|.|.|.|.|.|.|.|.|.|.|.|.|,.|.|.|.|.|.|.|.|.|.|.|.|.|.|.|.|,.|.|.|.|.|.|.|.|.|.|.|.|.|.|.|.|,.|.|.|.|.|.|.|.|.|.|.|.|.|.|.|.|,.|.|.|.|.|.|.|.|.|.|.|.|.|.|.|.|,.|.|.|.|.|.|.|.|.|.|.|.|.|.|.|.|,F|.|.|C|.|.|.|.|.|.|.|.|.|.|.|.|,.|C|.|C|.|.|.|.|.|.|.|.|.|.|.|.|,.|C|.|.|.|.|.|.|.|.|.|.|.|.|.|.|,.|.|.|.|.|.|.|.|.|.|.|.|.|.|.|.|,.|.|.|.|.|.|.|.|.|.|.|.|.|.|.|.|,.|.|.|.|.|.|.|.|.|.|.|.|.|.|.|.|,.|.|.|.|.|.|.|.|.|.|.|.|.|.|.|.|,.|.|.|.|.|.|.|.|.|.|.|.|.|.|.|.|,.|.|.|.|.|.|.|.|.|.|.|.|.|.|.|.|,.|.|.|.|.|.|.|.|.|.|.|.|.|.|.|.|,F|.|.|C|.|.|.|.|.|.|.|.|.|.|.|.|,F|.|.|C|.|.|.|.|.|.|.|.|.|.|.|.|,F|.|.|.|.|.|.|1|G|.|.|.|.|.|.|.|,.|.|.|C|.|.|.|.|.|.|.|.|.|.|.|.|,.|.|.|.|.|.|.|.|.|.|.|.|.|.|.|.|,.|.|.|.|.|.|.|.|.|.|.|.|.|.|.|.|,.|.|.|.|.|.|.|.|.|.|.|.|.|.|.|.|,.|.|.|.|.|.|.|.|.|.|.|.|.|.|.|.|
.|.|.|.|.|.|.|.|.|.|.|.|.|.|.|.|,.|.|.|.|.|.|.|.|.|.|.|.|.|.|.|.|,.|.|.|.|.|.|.|.|.|.|.|.|.|.|.|.|,.|.|.|.|.|.|.|.|.|.|.|.|.|.|.|.|,.|.|.|.|.|.|.|.|.|.|.|.|.|.|.|.|,.|.|.|.|.|.|.|.|.|.|.|.|.|.|.|.|,.|.|.|.|.|.|.|.|.|.|.|.|.|.|.|.|,.|.|.|.|.|.|.|.|.|.|.|.|.|.|.|.|,.|.|.|.|.|.|.|.|.|.|.|.|.|.|.|.|,.|.|.|.|.|.|.|.|.|.|.|.|.|.|.|.|,F|.|.|C|.|.|.|.|.|.|.|.|.|.|.|.|,.|.|.|C|.|.|.|.|.|.|.|.|.|.|.|.|,.|.|.|.|.|.|.|.|.|.|.|.|.|.|.|.|,.|.|.|.|.|.|.|.|.|.|.|.|.|.|.|.|,.|.|.|.|.|.|.|.|.|.|.|.|.|.|.|.|,.|.|.|.|.|.|.|.|.|.|.|.|.|.|.|.|,.|.|.|.|.|.|.|.|.|.|.|.|.|.|.|.|,.|.|.|.|.|.|.|.|.|.|.|.|.|.|.|.|,.|.|.|.|.|.|.|.|.|.|.|.|.|.|.|.|,.|.|.|.|.|.|.|.|.|.|.|.|.|.|.|.|,F|.|.|C|.|.|.|.|.|.|.|.|.|.|.|.|,.|C|.|C|.|.|.|.|.|.|.|.|.|.|.|.|,.|C|.|.|.|.|.|.|.|.|.|.|.|.|.|.|,.|.|.|.|.|.|.|.|.|.|.|.|.|.|.|.|,.|.|.|.|.|.|.|.|.|.|.|.|.|.|.|.|,.|.|.|.|.|.|.|.|.|.|.|.|.|.|.|.|,.|.|.|.|.|.|.|.|.|.|.|.|.|.|.|.|,.|.|.|.|.|.|.|.|.|.|.|.|.|.|.|.|
.|.|.|.|.|.|.|.|.|.|.|.|.|.|.|.|,.|.|.|.|.|.|.|.|.|.|.|.|.|.|.|.|,.|.|.|.|.|.|.|.|.|.|.|.|.|.|.|.|,.|.|.|.|.|.|.|.|.|.|.|.|.|.|.|.|,.|.|.|.|.|.|.|.|.|.|.|.|.|.|.|.|,.|.|.|.|.|.|.|.|.|.|.|.|.|.|.|.|,.|.|.|.|.|.|.|.|.|.|.|.|.|.|.|.|,.|.|.|.|.|.|.|.|.|.|.|.|.|.|.|.|,.|.|.|.|.|.|.|.|.|.|.|.|.|.|.|.|,.|.|.|.|.|.|.|.|.|.|.|.|.|.|.|.|,F|.|.|C|.|.|.|.|.|.|.|.|.|.|.|.|,.|.|.|C|.|.|.|.|.|.|.|.|.|.|.|.|,.|.|.|.|.|.|.|.|.|.|.|.|.|.|.|.|,.|.|.|.|.|.|.|.|.|.|.|.|.|.|.|.|,.|.|.|.|.|.|.|.|.|.|.|.|.|.|.|.|,F|C|.|C|.|.|.|.|.|.|C|.|.|.|.|.|,F|C|.|.|.|.|.|.|.|.|.|.|.|.|.|.|,.|.|.|C|.|.|.|.|.|.|.|.|.|.|.|.|,.|.|.|.|.|.|.|.|.|.|.|.|.|.|.|.|,.|.|.|.|.|.|.|.|.|.|.|.|.|.|.|.|,F|.|.|C|.|.|.|.|.|.|.|.|.|.|.|.|,F|C|.|C|.|.|D|.|.|.|.|.|.|.|.|.|,F|C|.|.|.|.|.|0|G|.|.|.|.|.|.|.|,.|.|.|C|.|.|.|.|.|.|.|.|.|.|.|.|,.|.|.|.|.|.|.|.|.|.|.|.|.|.|.|.|,.|.|.|.|.|.|.|.|.|.|.|.|.|.|.|.|,.|.|.|.|.|.|.|.|.|.|.|.|.|.|.|.|,.|.|.|.|.|.|.|.|.|.|.|.|.|.|.|.|
.|.|.|.|.|.|.|.|.|.|.|.|.|.|.|.|,.|.|.|.|.|.|.|.|.|.|.|.|.|.|.|.|,.|.|.|.|.|.|.|.|.|.|.|.|.|.|.|.|,.|.|.|.|.|.|.|.|.|.|.|.|.|.|.|.|,.|.|.|.|.|.|.|.|.|.|.|.|.|.|.|.|,.|.|.|.|.|.|.|.|.|.|.|.|.|.|.|.|,.|.|.|.|.|.|.|.|.|.|.|.|.|.|.|.|,.|.|.|.|.|.|.|.|.|.|.|.|.|.|.|.|,.|.|.|.|.|.|.|.|.|.|.|.|.|.|.|.|,.|.|.|.|.|.|.|.|.|.|.|.|.|.|.|.|,F|.|.|C|.|.|.|.|.|.|.|.|.|.|.|.|,.|.|.|C|.|.|.|.|.|.|.|.|.|.|.|.|,.|.|.|.|.|.|.|.|.|.|.|.|.|.|.|.|,.|.|.|.|.|.|.|.|.|.|.|.|.|.|.|.|,.|.|.|.|.|.|.|.|.|.|.|.|.|.|.|.|,F|.|.|C|.|.|.|3|G|.|.|.|.|.|.|.|,F|.|.|.|.|.|.|.|.|.|.|.|.|.|.|.|,.|.|.|C|.|.|.|.|.|.|.|.|.|.|.|.|,.|.|.|.|.|.|.|.|.|.|.|.|.|.|.|.|,F|C|.|C|.|.|.|.|.|.|.|.|.|.|.|.|,F|.|.|.|.|.|.|.|.|.|.|.|3|.|.|.|,F|C|.|.|.|.|.|.|.|.|.|.|.|.|.|.|,F|.|.|C|.|.|.|.|.|.|.|.|.|.|.|.|,.|.|.|C|.|.|.|.|.|.|.|.|.|.|.|.|,.|.|.|.|.|.|.|.|.|.|.|.|.|.|.|.|,.|.|.|.|.|.|.|.|.|.|.|.|.|.|.|.|,.|.|.|.|.|.|.|.|.|.|.|.|.|.|.|.|,.|.|.|.|.|.|.|.|.|.|.|.|.|.|.|.|
.|.|.|.|.|.|.|.|.|.|.|.|.|.|.|.|,.|.|.|.|.|.|.|.|.|.|.|.|.|.|.|.|,.|.|.|.|.|.|.|.|.|.|.|.|.|.|.|.|,.|.|.|.|.|.|.|.|.|.|.|.|.|.|.|.|,.|.|.|.|.|.|.|.|.|.|.|.|.|.|.|.|,.|.|.|.|.|.|.|.|.|.|.|.|.|.|.|.|,.|.|.|.|.|.|.|.|.|.|.|.|.|.|.|.|,.|.|.|.|.|.|.|.|.|.|.|.|.|.|.|.|,.|.|.|.|.|.|.|.|.|.|.|.|.|.|.|.|,.|.|.|.|.|.|.|.|.|.|.|.|.|.|.|.|,F|.|.|C|.|.|.|.|.|.|.|.|.|.|.|.|,F|C|.|.|.|.|.|.|.|.|.|.|.|.|.|.|,F|C|.|.|.|.|.|.|.|.|.|.|.|.|.|.|,F|C|.|.|.|.|.|.|.|.|.|.|.|.|.|.|,F|C|.|.|.|.|.|.|.|.|.|.|.|.|.|.|,F|C|.|.|.|.|.|.|.|.|.|.|.|.|.|.|,F|C|D|.|.|.|.|.|.|.|.|.|.|.|.|.|,F|C|.|.|.|.|.|.|.|.|.|.|.|.|.|.|,F|C|.|.|.|.|.|.|.|.|.|.|.|.|.|.|,F|.|.|.|.|.|.|2|G|.|.|.|.|.|.|.|,F|.|.|.|.|.|.|.|.|.|.|.|.|.|.|.|,F|.|.|.|.|.|.|2|G|.|.|.|.|.|.|.|,F|C|D|.|.|.|.|.|.|.|.|.|.|.|.|.|,.|.|.|C|.|.|.|.|.|.|.|.|.|.|.|.|,.|.|.|.|.|.|.|.|.|.|.|.|.|.|.|.|,.|.|.|.|.|.|.|.|.|.|.|.|.|.|.|.|,.|.|.|.|.|.|.|.|.|.|.|.|.|.|.|.|,.|.|.|.|.|.|.|.|.|.|.|.|.|.|.|.|
.|.|.|.|.|.|.|.|.|.|.|.|.|.|.|.|,.|.|.|.|.|.|.|.|.|.|.|.|.|.|.|.|,.|.|.|.|.|.|.|.|.|.|.|.|.|.|.|.|,.|.|.|.|.|.|.|.|.|.|.|.|.|.|.|.|,.|.|.|.|.|.|.|.|.|.|.|.|.|.|.|.|,.|.|.|.|.|.|.|.|.|.|.|.|.|.|.|.|,.|.|.|.|.|.|.|.|.|.|.|.|.|.|.|.|,.|.|.|.|.|.|.|.|.|.|.|.|.|.|.|.|,.|.|.|.|.|.|.|.|.|.|.|.|.|.|.|.|,.|.|.|.|.|.|.|.|.|.|.|.|.|.|.|.|,F|.|.|C|.|.|.|.|.|.|.|.|.|.|.|.|,.|C|.|C|.|.|.|.|.|.|.|.|.|.|.|.|,F|C|.|C|.|.|.|.|.|.|D|.|.|.|.|.|,F|C|D|.|.|.|.|.|.|.|.|.|.|.|.|.|,.|C|.|C|.|.|.|.|.|.|.|.|.|.|.|.|,.|C|.|.|.|.|.|.|.|.|.|.|.|.|.|.|,.|C|.|.|.|.|.|.|.|.|.|.|.|.|.|.|,.|C|.|.|.|.|.|.|.|.|.|.|.|.|.|.|,F|C|.|C|.|.|D|.|.|.|.|.|.|.|.|.|,F|C|.|.|.|.|.|.|.|.|F|.|.|.|.|.|,F|.|.|C|.|.|.|.|.|.|.|.|.|.|.|.|,.|C|.|C|.|.|.|.|.|.|.|.|.|.|.|.|,.|C|.|.|.|.|.|.|.|.|.|.|.|.|.|.|,.|.|.|.|.|.|.|.|.|.|.|.|.|.|.|.|,.|.|.|.|.|.|.|.|.|.|.|.|.|.|.|.|,.|.|.|.|.|.|.|.|.|.|.|.|.|.|.|.|,.|.|.|.|.|.|.|.|.|.|.|.|.|.|.|.|,.|.|.|.|.|.|.|.|.|.|.|.|.|.|.|.|
.|.|.|.|.|.|.|.|.|.|.|.|.|.|.|.|,.|.|.|.|.|.|.|.|.|.|.|.|.|.|.|.|,.|.|.|.|.|.|.|.|.|.|.|.|.|.|.|.|,.|.|.|.|.|.|.|.|.|.|.|.|.|.|.|.|,.|.|.|.|.|.|.|.|.|.|.|.|.|.|.|.|,.|.|.|.|.|.|.|.|.|.|.|.|.|.|.|.|,.|.|.|.|.|.|.|.|.|.|.|.|.|.|.|.|,.|.|.|.|.|.|.|.|.|.|.|.|.|.|.|.|,.|.|.|.|.|.|.|.|.|.|.|.|.|.|.|.|,.|.|.|.|.|.|.|.|.|.|.|.|.|.|.|.|,F|.|.|C|.|.|.|.|.|.|.|.|.|.|.|.|,.|.|.|C|.|.|.|.|.|.|.|.|.|.|.|.|,F|.|.|C|.|.|.|2|G|.|.|.|.|.|.|.|,F|.|.|.|.|.|.|.|.|.|G|.|.|.|.|.|,.|.|.|C|.|.|.|.|.|.|.|.|.|.|.|.|,.|.|.|.|.|.|.|.|.|.|.|.|.|.|.|.|,.|.|.|.|.|.|.|.|.|.|.|.|.|.|.|.|,.|.|.|.|.|.|.|.|.|.|.|.|.|.|.|.|,F|.|.|C|.|.|.|3|F|.|.|.|.|.|.|.|,F|.|.|.|.|.|.|.|.|.|.|.|.|.|.|.|,F|.|.|C|D|.|.|.|.|.|.|.|.|.|.|.|,.|.|.|C|.|.|.|.|.|.|.|.|.|.|.|.|,.|.|.|.|.|.|.|.|.|.|.|.|.|.|.|.|,.|.|.|.|.|.|.|.|.|.|.|.|.|.|.|.|,.|.|.|.|.|.|.|.|.|.|.|.|.|.|.|.|,.|.|.|.|.|.|.|.|.|.|.|.|.|.|.|.|,.|.|.|.|.|.|.|.|.|.|.|.|.|.|.|.|,.|.|.|.|.|.|.|.|.|.|.|.|.|.|.|.|
.|.|.|.|.|.|.|.|.|.|.|.|.|.|.|.|,.|.|.|.|.|.|.|.|.|.|.|.|.|.|.|.|,.|.|.|.|.|.|.|.|.|.|.|.|.|.|.|.|,.|.|.|.|.|.|.|.|.|.|.|.|.|.|.|.|,.|.|.|.|.|.|.|.|.|.|.|.|.|.|.|.|,.|.|.|.|.|.|.|.|.|.|.|.|.|.|.|.|,.|.|.|.|.|.|.|.|.|.|.|.|.|.|.|.|,.|.|.|.|.|.|.|.|.|.|.|.|.|.|.|.|,.|.|.|.|.|.|.|.|.|.|.|.|.|.|.|.|,.|.|.|.|.|.|.|.|.|.|.|.|.|.|.|.|,F|.|.|C|.|.|.|.|.|.|.|.|.|.|.|.|,.|.|.|C|.|.|.|.|.|.|.|.|.|.|.|.|,.|C|.|.|.|.|.|.|.|.|.|.|.|.|.|.|,.|C|.|.|.|.|.|.|.|.|.|.|.|.|.|.|,.|.|.|.|.|.|.|.|.|.|.|.|.|.|.|.|,.|.|.|.|.|.|.|.|.|.|.|.|.|.|.|.|,.|.|.|.|.|.|.|.|.|.|.|.|.|.|.|.|,.|.|.|.|.|.|.|.|.|.|.|.|.|.|.|.|,.|C|.|.|.|.|.|.|.|.|.|.|.|.|.|.|,.|C|.|.|.|.|.|.|.|.|.|.|.|.|.|.|,F|.|.|C|.|.|.|.|.|.|.|.|.|.|.|.|,.|.|.|C|.|.|.|.|.|.|.|.|.|.|.|.|,.|.|.|.|.|.|.|.|.|.|.|.|.|.|.|.|,.|.|.|.|.|.|.|.|.|.|.|.|.|.|.|.|,.|.|.|.|.|.|.|.|.|.|.|.|.|.|.|.|,.|.|.|.|.|.|.|.|.|.|.|.|.|.|.|.|,.|.|.|.|.|.|.|.|.|.|.|.|.|.|.|.|,.|.|.|.|.|.|.|.|.|.|.|.|.|.|.|.|
.|.|.|.|.|.|.|.|.|.|.|.|.|.|.|.|,.|.|.|.|.|.|.|.|.|.|.|.|.|.|.|.|,.|.|.|.|.|.|.|.|.|.|.|.|.|.|.|.|,.|.|.|.|.|.|.|.|.|.|.|.|.|.|.|.|,.|.|.|.|.|.|.|.|.|.|.|.|.|.|.|.|,.|.|.|.|.|.|.|.|.|.|.|.|.|.|.|.|,.|.|.|.|.|.|.|.|.|.|.|.|.|.|.|.|,.|.|.|.|.|.|.|.|.|.|.|.|.|.|.|.|,.|.|.|.|.|.|.|.|.|.|.|.|.|.|.|.|,.|.|.|.|.|.|.|.|.|.|.|.|.|.|.|.|,F|.|.|C|.|.|.|.|.|.|D|.|.|.|.|.|,F|C|.|C|.|1|S|.|.|.|.|.|.|.|.|.|,F|C|.|.|.|.|.|.|.|.|.|.|.|.|.|.|,F|C|.|.|.|.|.|.|.|.|.|.|.|.|.|.|,.|.|.|C|.|.|.|.|.|.|.|.|.|.|.|.|,.|.|.|.|.|.|.|.|.|.|.|.|.|.|.|.|,.|.|.|.|.|.|.|.|.|.|.|.|.|.|.|.|,.|.|.|.|.|.|.|.|.|.|.|.|.|.|.|.|,F|C|.|C|.|.|.|.|.|.|A|.|.|.|.|.|,F|C|.|.|.|0|L|.|.|.|.|.|.|.|.|.|,F|.|.|C|.|.|.|.|.|.|.|.|.|.|.|.|,.|.|.|C|.|.|.|.|.|.|.|.|.|.|.|.|,.|.|.|.|.|.|.|.|.|.|.|.|.|.|.|.|,.|.|.|.|.|.|.|.|.|.|.|.|.|.|.|.|,.|.|.|.|.|.|.|.|.|.|.|.|.|.|.|.|,.|.|.|.|.|.|.|.|.|.|.|.|.|.|.|.|,.|.|.|.|.|.|.|.|.|.|.|.|.|.|.|.|,.|.|.|.|.|.|.|.|.|.|.|.|.|.|.|.|
.|.|.|.|.|.|.|.|.|.|.|.|.|.|.|.|,.|.|.|.|.|.|.|.|.|.|.|.|.|.|.|.|,.|.|.|.|.|.|.|.|.|.|.|.|.|.|.|.|,.|.|.|.|.|.|.|.|.|.|.|.|.|.|.|.|,.|.|.|.|.|.|.|.|.|.|.|.|.|.|.|.|,.|.|.|.|.|.|.|.|.|.|.|.|.|.|.|.|,.|.|.|.|.|.|.|.|.|.|.|.|.|.|.|.|,.|.|.|.|.|.|.|.|.|.|.|.|.|.|.|.|,.|.|.|.|.|.|.|.|.|.|.|.|.|.|.|.|,.|.|.|.|.|.|.|.|.|.|.|.|.|.|.|.|,F|.|.|C|.|.|.|.|.|.|.|.|.|.|.|.|,F|.|.|C|.|.|.|0|G|.|.|.|.|.|.|.|,F|.|.|.|.|.|.|.|.|.|.|.|.|.|.|.|,F|.|.|.|.|.|.|.|.|.|.|.|.|.|.|.|,.|.|.|C|.|.|.|.|.|.|.|.|.|.|.|.|,.|.|.|.|.|.|.|.|.|.|.|.|.|.|.|.|,.|.|.|.|.|.|.|.|.|.|.|.|.|.|.|.|,.|.|.|.|.|.|.|.|.|.|.|.|.|.|.|.|,F|.|.|C|.|.|.|.|.|.|.|.|.|.|.|.|,F|.|.|.|.|.|.|.|.|.|.|.|.|.|.|.|,F|.|.|C|D|.|.|.|.|.|.|.|.|.|.|.|,.|.|.|C|.|.|.|.|.|.|.|.|.|.|.|.|,.|.|.|.|.|.|.|.|.|.|.|.|.|.|.|.|,.|.|.|.|.|.|.|.|.|.|.|.|.|.|.|.|,.|.|.|.|.|.|.|.|.|.|.|.|.|.|.|.|,.|.|.|.|.|.|.|.|.|.|.|.|.|.|.|.|,.|.|.|.|.|.|.|.|.|.|.|.|.|.|.|.|,.|.|.|.|.|.|.|.|.|.|.|.|.|.|.|.|
.|.|.|.|.|.|.|.|.|.|.|.|.|.|.|.|,.|.|.|.|.|.|.|.|.|.|.|.|.|.|.|.|,.|.|.|.|.|.|.|.|.|.|.|.|.|.|.|.|,.|.|.|.|.|.|.|.|.|.|.|.|.|.|.|.|,.|.|.|.|.|.|.|.|.|.|.|.|.|.|.|.|,.|.|.|.|.|.|.|.|.|.|.|.|.|.|.|.|,.|.|.|.|.|.|.|.|.|.|.|.|.|.|.|.|,.|.|.|.|.|.|.|.|.|.|.|.|.|.|.|.|,.|.|.|.|.|.|.|.|.|.|.|.|.|.|.|.|,.|.|.|.|.|.|.|.|.|.|.|.|.|.|.|.|,F|.|.|C|.|.|.|.|.|.|.|.|.|.|.|.|,F|.|.|C|D|.|.|.|.|.|.|.|.|.|.|.|,F|.|.|.|.|.|.|.|.|.|.|.|.|.|.|.|,F|.|.|.|.|.|.|1|H|.|.|.|.|.|.|.|,.|.|.|C|.|.|.|.|.|.|.|.|.|.|.|.|,.|.|.|.|.|.|.|.|.|.|.|.|.|.|.|.|,.|.|.|.|.|.|.|.|.|.|.|.|.|.|.|.|,.|.|.|.|.|.|.|.|.|.|.|.|.|.|.|.|,.|C|.|.|.|.|.|.|.|.|.|.|.|.|.|.|,.|C|.|.|.|.|.|.|.|.|.|.|.|.|.|.|,F|.|.|C|.|.|.|.|.|.|.|.|.|.|.|.|,.|.|.|C|.|.|.|.|.|.|.|.|.|.|.|.|,.|.|.|.|.|.|.|.|.|.|.|.|.|.|.|.|,.|.|.|.|.|.|.|.|.|.|.|.|.|.|.|.|,.|.|.|.|.|.|.|.|.|.|.|.|.|.|.|.|,.|.|.|.|.|.|.|.|.|.|.|.|.|.|.|.|,.|.|.|.|.|.|.|.|.|.|.|.|.|.|.|.|,.|.|.|.|.|.|.|.|.|.|.|.|.|.|.|.|
.|.|.|.|.|.|.|.|.|.|.|.|.|.|.|.|,.|.|.|.|.|.|.|.|.|.|.|.|.|.|.|.|,.|.|.|.|.|.|.|.|.|.|.|.|.|.|.|.|,.|.|.|.|.|.|.|.|.|.|.|.|.|.|.|.|,.|.|.|.|.|.|.|.|.|.|.|.|.|.|.|.|,.|.|.|.|.|.|.|.|.|.|.|.|.|.|.|.|,.|.|.|.|.|.|.|.|.|.|.|.|.|.|.|.|,.|.|.|.|.|.|.|.|.|.|.|.|.|.|.|.|,.|.|.|.|.|.|.|.|.|.|.|.|.|.|.|.|,.|.|.|.|.|.|.|.|.|.|.|.|.|.|.|.|,F|.|.|C|.|.|.|.|.|.|.|.|.|.|.|.|,F|.|.|C|D|.|.|.|.|.|.|.|.|.|.|.|,F|.|.|.|.|.|.|.|.|.|.|.|.|.|.|.|,F|.|.|.|.|.|.|1|H|.|.|.|5|.|.|.|,F|C|.|C|D|.|.|1|C|.|.|.|4|.|.|.|,.|.|.|C|.|.|.|.|.|.|.|.|.|.|.|.|,.|.|.|.|.|.|.|.|.|.|.|.|.|.|.|.|,.|.|.|.|.|.|.|.|.|.|.|.|.|.|.|.|,.|.|.|.|.|.|.|.|.|.|.|.|.|.|.|.|,.|.|.|.|.|.|.|.|.|.|.|.|.|.|.|.|,F|.|.|C|.|.|.|.|.|.|.|.|.|.|.|.|,F|C|.|C|.|.|.|.|.|.|.|.|.|.|.|.|,F|C|.|.|.|.|.|1|G|.|.|.|.|.|.|.|,.|.|.|C|.|.|.|.|.|.|.|.|.|.|.|.|,.|.|.|.|.|.|.|.|.|.|.|.|.|.|.|.|,.|.|.|.|.|.|.|.|.|.|.|.|.|.|.|.|,.|.|.|.|.|.|.|.|.|.|.|.|.|.|.|.|,.|.|.|.|.|.|.|.|.|.|.|.|.|.|.|.|
.|.|.|.|.|.|.|.|.|.|.|.|.|.|.|.|,.|.|.|.|.|.|.|.|.|.|.|.|.|.|.|.|,.|.|.|.|.|.|.|.|.|.|.|.|.|.|.|.|,.|.|.|.|.|.|.|.|.|.|.|.|.|.|.|.|,.|.|.|.|.|.|.|.|.|.|.|.|.|.|.|.|,.|.|.|.|.|.|.|.|.|.|.|.|.|.|.|.|,.|.|.|.|.|.|.|.|.|.|.|.|.|.|.|.|,.|.|.|.|.|.|.|.|.|.|.|.|.|.|.|.|,.|.|.|.|.|.|.|.|.|.|.|.|.|.|.|.|,.|.|.|.|.|.|.|.|.|.|.|.|.|.|.|.|,F|.|.|C|.|.|.|.|.|.|.|.|.|.|.|.|,F|.|.|C|.|.|.|2|G|.|.|.|.|.|.|.|,F|.|.|.|.|.|.|.|.|.|.|.|.|.|.|.|,F|.|.|.|.|.|.|.|.|.|.|.|.|.|.|.|,F|.|.|C|.|.|.|.|.|.|.|.|.|.|.|.|,.|.|.|C|.|.|.|.|.|.|.|.|.|.|.|.|,.|.|.|.|.|.|.|.|.|.|.|.|.|.|.|.|,.|.|.|.|.|.|.|.|.|.|.|.|.|.|.|.|,.|.|.|.|.|.|.|.|.|.|.|.|.|.|.|.|,.|.|.|.|.|.|.|.|.|.|.|.|.|.|.|.|,F|.|.|C|.|.|.|.|.|.|.|.|.|.|.|.|,F|.|.|C|D|.|.|.|.|.|B|.|.|.|.|.|,F|.|.|.|.|.|D|.|.|.|.|.|.|.|.|.|,.|.|.|C|.|.|.|.|.|.|.|.|.|.|.|.|,.|.|.|.|.|.|.|.|.|.|.|.|.|.|.|.|,.|.|.|.|.|.|.|.|.|.|.|.|.|.|.|.|,.|.|.|.|.|.|.|.|.|.|.|.|.|.|.|.|,.|.|.|.|.|.|.|.|.|.|.|.|.|.|.|.|
.|.|.|.|.|.|.|.|.|.|.|.|.|.|.|.|,.|.|.|.|.|.|.|.|.|.|.|.|.|.|.|.|,.|.|.|.|.|.|.|.|.|.|.|.|.|.|.|.|,.|.|.|.|.|.|.|.|.|.|.|.|.|.|.|.|,.|.|.|.|.|.|.|.|.|.|.|.|.|.|.|.|,.|.|.|.|.|.|.|.|.|.|.|.|.|.|.|.|,.|.|.|.|.|.|.|.|.|.|.|.|.|.|.|.|,.|.|.|.|.|.|.|.|.|.|.|.|.|.|.|.|,.|.|.|.|.|.|.|.|.|.|.|.|.|.|.|.|,.|.|.|.|.|.|.|.|.|.|.|.|.|.|.|.|,F|.|.|C|.|.|.|.|.|.|.|.|.|.|.|.|,F|.|.|C|.|.|.|.|.|.|.|.|.|.|.|.|,F|.|.|.|.|.|.|.|.|.|.|.|.|.|.|.|,F|.|.|.|.|.|.|.|.|.|.|.|.|.|.|.|,.|C|.|C|.|.|.|.|.|.|.|.|.|.|.|.|,.|.|.|.|.|.|.|.|.|.|.|.|.|.|.|.|,.|.|.|.|.|.|.|.|.|.|.|.|.|.|.|.|,.|.|.|.|.|.|.|.|.|.|.|.|.|.|.|.|,.|.|.|.|.|.|.|.|.|.|.|.|.|.|.|.|,.|.|.|.|.|.|.|.|.|.|.|.|.|.|.|.|,F|.|.|C|.|.|.|.|.|.|.|.|.|.|.|.|,.|C|.|C|.|.|.|.|.|.|.|.|.|.|.|.|,.|C|.|.|.|.|.|.|.|.|.|.|.|.|.|.|,.|.|.|.|.|.|.|.|.|.|.|.|.|.|.|.|,.|.|.|.|.|.|.|.|.|.|.|.|.|.|.|.|,.|.|.|.|.|.|.|.|.|.|.|.|.|.|.|.|,.|.|.|.|.|.|.|.|.|.|.|.|.|.|.|.|,.|.|.|.|.|.|.|.|.|.|.|.|.|.|.|.|
.|.|.|.|.|.|.|.|.|.|.|.|.|.|.|.|,.|.|.|.|.|.|.|.|.|.|.|.|.|.|.|.|,.|.|.|.|.|.|.|.|.|.|.|.|.|.|.|.|,.|.|.|.|.|.|.|.|.|.|.|.|.|.|.|.|,.|.|.|.|.|.|.|.|.|.|.|.|.|.|.|.|,.|.|.|.|.|.|.|.|.|.|.|.|.|.|.|.|,.|.|.|.|.|.|.|.|.|.|.|.|.|.|.|.|,.|.|.|.|.|.|.|.|.|.|.|.|.|.|.|.|,.|.|.|.|.|.|.|.|.|.|.|.|.|.|.|.|,.|.|.|.|.|.|.|.|.|.|.|.|.|.|.|.|,F|.|.|C|.|.|.|.|.|.|.|.|.|.|.|.|,.|C|.|C|.|.|.|.|.|.|.|.|.|.|.|.|,.|C|.|.|.|.|.|.|.|.|.|.|.|.|.|.|,.|C|.|.|.|.|.|.|.|.|.|.|.|.|.|.|,.|.|.|.|.|.|.|.|.|.|.|.|.|.|.|.|,.|.|.|.|.|.|.|.|.|.|.|.|.|.|.|.|,.|.|.|.|.|.|.|.|.|.|.|.|.|.|.|.|,.|.|.|.|.|.|.|.|.|.|.|.|.|.|.|.|,.|.|.|.|.|.|.|.|.|.|.|.|.|.|.|.|,.|.|.|.|.|.|.|.|.|.|.|.|.|.|.|.|,F|.|.|C|.|.|.|.|.|.|A|.|.|.|.|.|,.|.|.|C|.|.|.|.|.|.|.|.|.|.|.|.|,.|.|.|.|.|.|.|.|.|.|.|.|.|.|.|.|,.|.|.|.|.|.|.|.|.|.|.|.|.|.|.|.|,.|.|.|.|.|.|.|.|.|.|.|.|.|.|.|.|,.|.|.|.|.|.|.|.|.|.|.|.|.|.|.|.|,.|.|.|.|.|.|.|.|.|.|.|.|.|.|.|.|,.|.|.|.|.|.|.|.|.|.|.|.|.|.|.|.|
.|.|.|.|.|.|.|.|.|.|.|.|.|.|.|.|,.|.|.|.|.|.|.|.|.|.|.|.|.|.|.|.|,.|.|.|.|.|.|.|.|.|.|.|.|.|.|.|.|,.|.|.|.|.|.|.|.|.|.|.|.|.|.|.|.|,.|.|.|.|.|.|.|.|.|.|.|.|.|.|.|.|,.|.|.|.|.|.|.|.|.|.|.|.|.|.|.|.|,.|.|.|.|.|.|.|.|.|.|.|.|.|.|.|.|,.|.|.|.|.|.|.|.|.|.|.|.|.|.|.|.|,.|.|.|.|.|.|.|.|.|.|.|.|.|.|.|.|,.|.|.|.|.|.|.|.|.|.|.|.|.|.|.|.|,.|C|.|.|.|.|.|.|.|.|.|.|.|.|.|.|,.|.|.|.|.|.|.|.|.|.|.|.|.|.|.|.|,.|.|.|.|.|.|.|.|.|.|.|.|.|.|.|.|,.|.|.|.|.|.|.|.|.|.|.|.|.|.|.|.|,.|.|.|.|.|.|.|.|.|.|.|.|.|.|.|.|,.|.|.|.|.|.|.|.|.|.|.|.|.|.|.|.|,.|.|.|.|.|.|.|.|.|.|.|.|.|.|.|.|,.|.|.|.|.|.|.|.|.|.|.|.|.|.|.|.|,.|.|.|.|.|.|.|.|.|.|.|.|.|.|.|.|,.|.|.|.|.|.|.|.|.|.|.|.|.|.|.|.|,.|C|.|.|.|.|.|.|.|.|.|.|.|.|.|.|,.|.|.|.|.|.|.|.|.|.|.|.|.|.|.|.|,.|.|.|.|.|.|.|.|.|.|.|.|.|.|.|.|,.|.|.|.|.|.|.|.|.|.|.|.|.|.|.|.|,.|.|.|.|.|.|.|.|.|.|.|.|.|.|.|.|,.|.|.|.|.|.|.|.|.|.|.|.|.|.|.|.|,.|.|.|.|.|.|.|.|.|.|.|.|.|.|.|.|,.|.|.|.|.|.|.|.|.|.|.|.|.|.|.|.|
.|.|.|.|.|.|.|.|.|.|.|.|.|.|.|.|,.|.|.|.|.|.|.|.|.|.|.|.|.|.|.|.|,.|.|.|.|.|.|.|.|.|.|.|.|.|.|.|.|,.|.|.|.|.|.|.|.|.|.|.|.|.|.|.|.|,.|.|.|.|.|.|.|.|.|.|.|.|.|.|.|.|,.|.|.|.|.|.|.|.|.|.|.|.|.|.|.|.|,.|.|.|.|.|.|.|.|.|.|.|.|.|.|.|.|,.|.|.|.|.|.|.|.|.|.|.|.|.|.|.|.|,.|.|.|.|.|.|.|.|.|.|.|.|.|.|.|.|,.|.|.|.|.|.|.|.|.|.|.|.|.|.|.|.|,.|.|.|.|.|.|.|.|.|.|.|.|.|.|.|.|,.|.|.|.|.|.|.|.|.|.|.|.|.|.|.|.|,.|.|.|.|.|.|.|.|.|.|.|.|.|.|.|.|,.|.|.|.|.|.|.|.|.|.|.|.|.|.|.|.|,.|.|.|.|.|.|.|.|.|.|.|.|.|.|.|.|,.|.|.|.|.|.|.|.|.|.|.|.|.|.|.|.|,.|.|.|.|.|.|.|.|.|.|.|.|.|.|.|.|,.|.|.|.|.|.|.|.|.|.|.|.|.|.|.|.|,.|.|.|.|.|.|.|.|.|.|.|.|.|.|.|.|,.|.|.|.|.|.|.|.|.|.|.|.|.|.|.|.|,.|.|.|.|.|.|.|.|.|.|.|.|.|.|.|.|,.|.|.|.|.|.|.|.|.|.|.|.|.|.|.|.|,.|.|.|.|.|.|.|.|.|.|.|.|.|.|.|.|,.|.|.|.|.|.|.|.|.|.|.|.|.|.|.|.|,.|.|.|.|.|.|.|.|.|.|.|.|.|.|.|.|,.|.|.|.|.|.|.|.|.|.|.|.|.|.|.|.|,.|.|.|.|.|.|.|.|.|.|.|.|.|.|.|.|,.|.|.|.|.|.|.|.|.|.|.|.|.|.|.|.|
.|.|.|.|.|.|.|.|.|.|.|.|.|.|.|.|,.|.|.|.|.|.|.|.|.|.|.|.|.|.|.|.|,.|.|.|.|.|.|.|.|.|.|.|.|.|.|.|.|,.|.|.|.|.|.|.|.|.|.|.|.|.|.|.|.|,.|.|.|.|.|.|.|.|.|.|.|.|.|.|.|.|,.|.|.|.|.|.|.|.|.|.|.|.|.|.|.|.|,.|.|.|.|.|.|.|.|.|.|.|.|.|.|.|.|,.|.|.|.|.|.|.|.|.|.|.|.|.|.|.|.|,.|.|.|.|.|.|.|.|.|.|.|.|.|.|.|.|,.|.|.|.|.|.|.|.|.|.|.|.|.|.|.|.|,.|.|.|.|.|.|.|.|.|.|.|.|.|.|.|.|,.|.|.|.|.|.|.|.|.|.|.|.|.|.|.|.|,.|.|.|.|.|.|.|.|.|.|.|.|.|.|.|.|,.|.|.|.|.|.|.|.|.|.|.|.|.|.|.|.|,.|.|.|.|.|.|.|.|.|.|.|.|.|.|.|.|,.|.|.|.|.|.|.|.|.|.|.|.|.|.|.|.|,.|.|.|.|.|.|.|.|.|.|.|.|.|.|.|.|,.|.|.|.|.|.|.|.|.|.|.|.|.|.|.|.|,.|.|.|.|.|.|.|.|.|.|.|.|.|.|.|.|,.|.|.|.|.|.|.|.|.|.|.|.|.|.|.|.|,.|.|.|.|.|.|.|.|.|.|.|.|.|.|.|.|,.|.|.|.|.|.|.|.|.|.|.|.|.|.|.|.|,.|.|.|.|.|.|.|.|.|.|.|.|.|.|.|.|,.|.|.|.|.|.|.|.|.|.|.|.|.|.|.|.|,.|.|.|.|.|.|.|.|.|.|.|.|.|.|.|.|,.|.|.|.|.|.|.|.|.|.|.|.|.|.|.|.|,.|.|.|.|.|.|.|.|.|.|.|.|.|.|.|.|,.|.|.|.|.|.|.|.|.|.|.|.|.|.|.|.|
.|.|.|.|.|.|.|.|.|.|.|.|.|.|.|.|,.|.|.|.|.|.|.|.|.|.|.|.|.|.|.|.|,.|.|.|.|.|.|.|.|.|.|.|.|.|.|.|.|,.|.|.|.|.|.|.|.|.|.|.|.|.|.|.|.|,.|.|.|.|.|.|.|.|.|.|.|.|.|.|.|.|,.|.|.|.|.|.|.|.|.|.|.|.|.|.|.|.|,.|.|.|.|.|.|.|.|.|.|.|.|.|.|.|.|,.|.|.|.|.|.|.|.|.|.|.|.|.|.|.|.|,.|.|.|.|.|.|.|.|.|.|.|.|.|.|.|.|,.|.|.|.|.|.|.|.|.|.|.|.|.|.|.|.|,.|.|.|.|.|.|.|.|.|.|.|.|.|.|.|.|,.|.|.|.|.|.|.|.|.|.|.|.|.|.|.|.|,.|.|.|.|.|.|.|.|.|.|.|.|.|.|.|.|,.|.|.|.|.|.|.|.|.|.|.|.|.|.|.|.|,.|.|.|.|.|.|.|.|.|.|.|.|.|.|.|.|,.|.|.|.|.|.|.|.|.|.|.|.|.|.|.|.|,.|.|.|.|.|.|.|.|.|.|.|.|.|.|.|.|,.|.|.|.|.|.|.|.|.|.|.|.|.|.|.|.|,.|.|.|.|.|.|.|.|.|.|.|.|.|.|.|.|,.|.|.|.|.|.|.|.|.|.|.|.|.|.|.|.|,.|.|.|.|.|.|.|.|.|.|.|.|.|.|.|.|,.|.|.|.|.|.|.|.|.|.|.|.|.|.|.|.|,.|.|.|.|.|.|.|.|.|.|.|.|.|.|.|.|,.|.|.|.|.|.|.|.|.|.|.|.|.|.|.|.|,.|.|.|.|.|.|.|.|.|.|.|.|.|.|.|.|,.|.|.|.|.|.|.|.|.|.|.|.|.|.|.|.|,.|.|.|.|.|.|.|.|.|.|.|.|.|.|.|.|,.|.|.|.|.|.|.|.|.|.|.|.|.|.|.|.|
.|.|.|.|.|.|.|.|.|.|.|.|.|.|.|.|,.|.|.|.|.|.|.|.|.|.|.|.|.|.|.|.|,.|.|.|.|.|.|.|.|.|.|.|.|.|.|.|.|,.|.|.|.|.|.|.|.|.|.|.|.|.|.|.|.|,.|.|.|.|.|.|.|.|.|.|.|.|.|.|.|.|,.|.|.|.|.|.|.|.|.|.|.|.|.|.|.|.|,.|.|.|.|.|.|.|.|.|.|.|.|.|.|.|.|,.|.|.|.|.|.|.|.|.|.|.|.|.|.|.|.|,.|.|.|.|.|.|.|.|.|.|.|.|.|.|.|.|,.|.|.|.|.|.|.|.|.|.|.|.|.|.|.|.|,.|.|.|.|.|.|.|.|.|.|.|.|.|.|.|.|,.|.|.|.|.|.|.|.|.|.|.|.|.|.|.|.|,.|.|.|.|.|.|.|.|.|.|.|.|.|.|.|.|,.|.|.|.|.|.|.|.|.|.|.|.|.|.|.|.|,.|.|.|.|.|.|.|.|.|.|.|.|.|.|.|.|,.|.|.|.|.|.|.|.|.|.|.|.|.|.|.|.|,.|.|.|.|.|.|.|.|.|.|.|.|.|.|.|.|,.|.|.|.|.|.|.|.|.|.|.|.|.|.|.|.|,.|.|.|.|.|.|.|.|.|.|.|.|.|.|.|.|,.|.|.|.|.|.|.|.|.|.|.|.|.|.|.|.|,.|.|.|.|.|.|.|.|.|.|.|.|.|.|.|.|,.|.|.|.|.|.|.|.|.|.|.|.|.|.|.|.|,.|.|.|.|.|.|.|.|.|.|.|.|.|.|.|.|,.|.|.|.|.|.|.|.|.|.|.|.|.|.|.|.|,.|.|.|.|.|.|.|.|.|.|.|.|.|.|.|.|,.|.|.|.|.|.|.|.|.|.|.|.|.|.|.|.|,.|.|.|.|.|.|.|.|.|.|.|.|.|.|.|.|,.|.|.|.|.|.|.|.|.|.|.|.|.|.|.|.|
.|.|.|.|.|.|.|.|.|.|.|.|.|.|.|.|,.|.|.|.|.|.|.|.|.|.|.|.|.|.|.|.|,.|.|.|.|.|.|.|.|.|.|.|.|.|.|.|.|,.|.|.|.|.|.|.|.|.|.|.|.|.|.|.|.|,.|.|.|.|.|.|.|.|.|.|.|.|.|.|.|.|,.|.|.|.|.|.|.|.|.|.|.|.|.|.|.|.|,.|.|.|.|.|.|.|.|.|.|.|.|.|.|.|.|,.|.|.|.|.|.|.|.|.|.|.|.|.|.|.|.|,.|.|.|.|.|.|.|.|.|.|.|.|.|.|.|.|,.|.|.|.|.|.|.|.|.|.|.|.|.|.|.|.|,.|.|.|.|.|.|.|.|.|.|.|.|.|.|.|.|,.|.|.|.|.|.|.|.|.|.|.|.|.|.|.|.|,.|.|.|.|.|.|.|.|.|.|.|.|.|.|.|.|,.|.|.|.|.|.|.|.|.|.|.|.|.|.|.|.|,.|.|.|.|.|.|.|.|.|.|.|.|.|.|.|.|,.|.|.|.|.|.|.|.|.|.|.|.|.|.|.|.|,.|.|.|.|.|.|.|.|.|.|.|.|.|.|.|.|,.|.|.|.|.|.|.|.|.|.|.|.|.|.|.|.|,.|.|.|.|.|.|.|.|.|.|.|.|.|.|.|.|,.|.|.|.|.|.|.|.|.|.|.|.|.|.|.|.|,.|.|.|.|.|.|.|.|.|.|.|.|.|.|.|.|,.|.|.|.|.|.|.|.|.|.|.|.|.|.|.|.|,.|.|.|.|.|.|.|.|.|.|.|.|.|.|.|.|,.|.|.|.|.|.|.|.|.|.|.|.|.|.|.|.|,.|.|.|.|.|.|.|.|.|.|.|.|.|.|.|.|,.|.|.|.|.|.|.|.|.|.|.|.|.|.|.|.|,.|.|.|.|.|.|.|.|.|.|.|.|.|.|.|.|,.|.|.|.|.|.|.|.|.|.|.|.|.|.|.|.|
